geoid,name,B25003001,"B25003001, Error",B25003002,"B25003002, Error",B25003003,"B25003003, Error"
14000US24001000100,"Census Tract 1, Allegany, MD",1452,179,1145,173,307,113
14000US24001000200,"Census Tract 2, Allegany, MD",1352,199,1189,219,163,80
14000US24001000500,"Census Tract 5, Allegany, MD",827,125,495,106,332,108
14000US24001000600,"Census Tract 6, Allegany, MD",1305,172,896,163,409,133
14000US24001000700,"Census Tract 7, Allegany, MD",1448,178,625,149,823,182
14000US24001000800,"Census Tract 8, Allegany, MD",825,99,435,83,390,87
14000US24001001000,"Census Tract 10, Allegany, MD",1023,140,435,115,588,151
14000US24001001100,"Census Tract 11, Allegany, MD",681,96,192,60,489,92
14000US24001001200,"Census Tract 12, Allegany, MD",1290,169,1129,174,161,67
14000US24001001300,"Census Tract 13, Allegany, MD",1007,122,715,121,292,95
14000US24001001401,"Census Tract 14.01, Allegany, MD",1624,168,1473,159,151,53
14000US24001001402,"Census Tract 14.02, Allegany, MD",713,125,563,131,150,58
14000US24001001502,"Census Tract 15.02, Allegany, MD",842,118,636,97,206,94
14000US24001001503,"Census Tract 15.03, Allegany, MD",685,109,524,115,161,57
14000US24001001600,"Census Tract 16, Allegany, MD",616,107,454,86,162,71
14000US24001001700,"Census Tract 17, Allegany, MD",1699,183,990,196,709,200
14000US24001001800,"Census Tract 18, Allegany, MD",1351,171,609,130,742,140
14000US24001001900,"Census Tract 19, Allegany, MD",1153,135,998,142,155,63
14000US24001002000,"Census Tract 20, Allegany, MD",2429,283,1871,271,558,255
14000US24001002100,"Census Tract 21, Allegany, MD",1153,155,879,107,274,108
14000US24001002200,"Census Tract 22, Allegany, MD",1468,158,1197,152,271,92
14000US24001002300,"Census Tract 23, Allegany, MD",2493,271,1844,277,649,176
14000US24003701101,"Census Tract 7011.01, Anne Arundel, MD",1513,205,1398,204,115,64
14000US24003701103,"Census Tract 7011.03, Anne Arundel, MD",1485,277,1230,324,255,122
14000US24003701104,"Census Tract 7011.04, Anne Arundel, MD",1367,125,1205,152,162,92
14000US24003701201,"Census Tract 7012.01, Anne Arundel, MD",1389,168,1257,188,132,97
14000US24003701202,"Census Tract 7012.02, Anne Arundel, MD",1606,253,1431,271,175,92
14000US24003701301,"Census Tract 7013.01, Anne Arundel, MD",1366,158,1306,146,60,48
14000US24003701302,"Census Tract 7013.02, Anne Arundel, MD",1377,172,1232,189,145,87
14000US24003701400,"Census Tract 7014, Anne Arundel, MD",1296,242,1189,244,107,69
14000US24003702100,"Census Tract 7021, Anne Arundel, MD",2526,206,2232,198,294,154
14000US24003702204,"Census Tract 7022.04, Anne Arundel, MD",1594,201,1383,170,211,112
14000US24003702205,"Census Tract 7022.05, Anne Arundel, MD",2409,154,1746,223,663,206
14000US24003702206,"Census Tract 7022.06, Anne Arundel, MD",2504,277,2180,307,324,146
14000US24003702208,"Census Tract 7022.08, Anne Arundel, MD",2887,274,2305,317,582,170
14000US24003702209,"Census Tract 7022.09, Anne Arundel, MD",1318,108,1152,116,166,90
14000US24003702300,"Census Tract 7023, Anne Arundel, MD",2056,300,1987,301,69,47
14000US24003702402,"Census Tract 7024.02, Anne Arundel, MD",3997,301,2129,331,1868,282
14000US24003702500,"Census Tract 7025, Anne Arundel, MD",2529,288,1558,278,971,248
14000US24003702601,"Census Tract 7026.01, Anne Arundel, MD",2139,341,1871,352,268,142
14000US24003702602,"Census Tract 7026.02, Anne Arundel, MD",2432,320,2224,342,208,107
14000US24003702702,"Census Tract 7027.02, Anne Arundel, MD",1526,166,1336,174,190,89
14000US24003702703,"Census Tract 7027.03, Anne Arundel, MD",1390,444,1056,467,334,100
14000US24003702704,"Census Tract 7027.04, Anne Arundel, MD",1419,200,253,105,1166,206
14000US24003706102,"Census Tract 7061.02, Anne Arundel, MD",1174,168,706,162,468,113
14000US24003706103,"Census Tract 7061.03, Anne Arundel, MD",788,104,290,109,498,115
14000US24003706302,"Census Tract 7063.02, Anne Arundel, MD",1954,216,1165,201,789,147
14000US24003706303,"Census Tract 7063.03, Anne Arundel, MD",1357,254,935,216,422,179
14000US24003706304,"Census Tract 7063.04, Anne Arundel, MD",1396,194,743,159,653,212
14000US24003706402,"Census Tract 7064.02, Anne Arundel, MD",1719,253,1064,202,655,194
14000US24003706403,"Census Tract 7064.03, Anne Arundel, MD",1460,176,1070,186,390,153
14000US24003706404,"Census Tract 7064.04, Anne Arundel, MD",1064,220,589,213,475,105
14000US24003706500,"Census Tract 7065, Anne Arundel, MD",2321,268,1425,253,896,202
14000US24003706600,"Census Tract 7066, Anne Arundel, MD",2297,266,1503,244,794,206
14000US24003706700,"Census Tract 7067, Anne Arundel, MD",187,73,0,14,187,73
14000US24003707001,"Census Tract 7070.01, Anne Arundel, MD",2162,245,1904,240,258,113
14000US24003707002,"Census Tract 7070.02, Anne Arundel, MD",1782,163,1645,161,137,77
14000US24003708001,"Census Tract 7080.01, Anne Arundel, MD",1420,181,1360,175,60,44
14000US24003708004,"Census Tract 7080.04, Anne Arundel, MD",2060,192,2025,188,35,41
14000US24003730101,"Census Tract 7301.01, Anne Arundel, MD",844,114,844,114,0,14
14000US24003730102,"Census Tract 7301.02, Anne Arundel, MD",4583,344,3538,309,1045,344
14000US24003730204,"Census Tract 7302.04, Anne Arundel, MD",2758,367,2500,368,258,131
14000US24003730205,"Census Tract 7302.05, Anne Arundel, MD",1218,195,139,87,1079,202
14000US24003730206,"Census Tract 7302.06, Anne Arundel, MD",1593,225,973,225,620,170
14000US24003730300,"Census Tract 7303, Anne Arundel, MD",1215,188,1115,204,100,75
14000US24003730401,"Census Tract 7304.01, Anne Arundel, MD",2218,324,1807,332,411,123
14000US24003730403,"Census Tract 7304.03, Anne Arundel, MD",1631,210,595,168,1036,204
14000US24003730404,"Census Tract 7304.04, Anne Arundel, MD",801,119,433,83,368,146
14000US24003730507,"Census Tract 7305.07, Anne Arundel, MD",1587,288,1554,286,33,32
14000US24003730508,"Census Tract 7305.08, Anne Arundel, MD",953,173,276,134,677,184
14000US24003730509,"Census Tract 7305.09, Anne Arundel, MD",1898,157,1399,213,499,154
14000US24003730510,"Census Tract 7305.10, Anne Arundel, MD",1187,150,1000,151,187,166
14000US24003730511,"Census Tract 7305.11, Anne Arundel, MD",775,70,17,18,758,75
14000US24003730512,"Census Tract 7305.12, Anne Arundel, MD",990,142,271,126,719,129
14000US24003730513,"Census Tract 7305.13, Anne Arundel, MD",687,80,460,92,227,95
14000US24003730514,"Census Tract 7305.14, Anne Arundel, MD",1396,281,21,25,1375,282
14000US24003730601,"Census Tract 7306.01, Anne Arundel, MD",2351,268,2219,233,132,121
14000US24003730603,"Census Tract 7306.03, Anne Arundel, MD",993,131,906,139,87,70
14000US24003730605,"Census Tract 7306.05, Anne Arundel, MD",1101,325,851,296,250,157
14000US24003730606,"Census Tract 7306.06, Anne Arundel, MD",1674,172,1549,171,125,54
14000US24003730701,"Census Tract 7307.01, Anne Arundel, MD",1022,168,844,179,178,110
14000US24003730702,"Census Tract 7307.02, Anne Arundel, MD",1506,164,1390,179,116,94
14000US24003730800,"Census Tract 7308, Anne Arundel, MD",910,108,841,104,69,39
14000US24003730901,"Census Tract 7309.01, Anne Arundel, MD",992,202,675,71,317,195
14000US24003730902,"Census Tract 7309.02, Anne Arundel, MD",1266,124,1243,121,23,27
14000US24003731002,"Census Tract 7310.02, Anne Arundel, MD",1343,182,1221,200,122,59
14000US24003731003,"Census Tract 7310.03, Anne Arundel, MD",1659,188,1494,189,165,108
14000US24003731004,"Census Tract 7310.04, Anne Arundel, MD",1586,188,1387,188,199,81
14000US24003731103,"Census Tract 7311.03, Anne Arundel, MD",1968,287,1811,283,157,68
14000US24003731104,"Census Tract 7311.04, Anne Arundel, MD",1719,316,1501,297,218,140
14000US24003731105,"Census Tract 7311.05, Anne Arundel, MD",1116,103,1027,105,89,49
14000US24003731106,"Census Tract 7311.06, Anne Arundel, MD",1730,179,1059,180,671,158
14000US24003731107,"Census Tract 7311.07, Anne Arundel, MD",1235,180,1169,183,66,55
14000US24003731201,"Census Tract 7312.01, Anne Arundel, MD",2245,224,2003,245,242,138
14000US24003731205,"Census Tract 7312.05, Anne Arundel, MD",1696,209,1571,216,125,68
14000US24003731206,"Census Tract 7312.06, Anne Arundel, MD",1332,294,1185,315,147,88
14000US24003731207,"Census Tract 7312.07, Anne Arundel, MD",1088,112,974,115,114,54
14000US24003731208,"Census Tract 7312.08, Anne Arundel, MD",1511,353,1442,360,69,69
14000US24003731209,"Census Tract 7312.09, Anne Arundel, MD",2181,184,1095,172,1086,199
14000US24003731210,"Census Tract 7312.10, Anne Arundel, MD",804,137,775,138,29,26
14000US24003731303,"Census Tract 7313.03, Anne Arundel, MD",2435,277,2295,278,140,122
14000US24003731306,"Census Tract 7313.06, Anne Arundel, MD",2198,267,2167,264,31,34
14000US24003731307,"Census Tract 7313.07, Anne Arundel, MD",2260,171,2051,193,209,102
14000US24003731308,"Census Tract 7313.08, Anne Arundel, MD",1491,246,1295,255,196,80
14000US24003731309,"Census Tract 7313.09, Anne Arundel, MD",1979,156,1608,162,371,180
14000US24003731310,"Census Tract 7313.10, Anne Arundel, MD",1842,237,1674,223,168,81
14000US24003731312,"Census Tract 7313.12, Anne Arundel, MD",1495,187,1366,206,129,119
14000US24003731313,"Census Tract 7313.13, Anne Arundel, MD",1379,425,1143,449,236,110
14000US24003740103,"Census Tract 7401.03, Anne Arundel, MD",3368,336,3119,369,249,138
14000US24003740104,"Census Tract 7401.04, Anne Arundel, MD",3049,282,2235,327,814,247
14000US24003740105,"Census Tract 7401.05, Anne Arundel, MD",1593,260,716,260,877,206
14000US24003740106,"Census Tract 7401.06, Anne Arundel, MD",1302,183,744,155,558,209
14000US24003740107,"Census Tract 7401.07, Anne Arundel, MD",1614,166,785,184,829,147
14000US24003740108,"Census Tract 7401.08, Anne Arundel, MD",2620,295,1485,213,1135,311
14000US24003740203,"Census Tract 7402.03, Anne Arundel, MD",1928,209,1830,225,98,81
14000US24003740204,"Census Tract 7402.04, Anne Arundel, MD",1779,366,875,312,904,243
14000US24003740205,"Census Tract 7402.05, Anne Arundel, MD",1236,232,880,231,356,143
14000US24003740303,"Census Tract 7403.03, Anne Arundel, MD",1738,201,1618,219,120,77
14000US24003740304,"Census Tract 7403.04, Anne Arundel, MD",3294,376,1237,271,2057,335
14000US24003740305,"Census Tract 7403.05, Anne Arundel, MD",4577,571,2588,526,1989,695
14000US24003740400,"Census Tract 7404, Anne Arundel, MD",0,14,0,14,0,14
14000US24003740501,"Census Tract 7405.01, Anne Arundel, MD",2466,228,1239,263,1227,305
14000US24003740502,"Census Tract 7405.02, Anne Arundel, MD",2000,323,1210,265,790,299
14000US24003740601,"Census Tract 7406.01, Anne Arundel, MD",1948,197,704,147,1244,182
14000US24003740602,"Census Tract 7406.02, Anne Arundel, MD",1047,143,0,14,1047,143
14000US24003740603,"Census Tract 7406.03, Anne Arundel, MD",863,119,0,14,863,119
14000US24003740701,"Census Tract 7407.01, Anne Arundel, MD",2950,323,2213,299,737,224
14000US24003740703,"Census Tract 7407.03, Anne Arundel, MD",2022,357,1765,356,257,147
14000US24003740704,"Census Tract 7407.04, Anne Arundel, MD",3136,228,2479,237,657,163
14000US24003740800,"Census Tract 7408, Anne Arundel, MD",1708,200,1555,215,153,94
14000US24003740900,"Census Tract 7409, Anne Arundel, MD",2740,256,1994,253,746,228
14000US24003741000,"Census Tract 7410, Anne Arundel, MD",857,70,789,83,68,46
14000US24003750101,"Census Tract 7501.01, Anne Arundel, MD",1549,225,1215,223,334,113
14000US24003750102,"Census Tract 7501.02, Anne Arundel, MD",966,123,774,123,192,94
14000US24003750201,"Census Tract 7502.01, Anne Arundel, MD",1134,103,931,120,203,85
14000US24003750204,"Census Tract 7502.04, Anne Arundel, MD",1891,182,1709,193,182,100
14000US24003750300,"Census Tract 7503, Anne Arundel, MD",984,130,836,124,148,63
14000US24003750400,"Census Tract 7504, Anne Arundel, MD",1503,142,1389,155,114,68
14000US24003750801,"Census Tract 7508.01, Anne Arundel, MD",1993,205,1816,221,177,131
14000US24003750803,"Census Tract 7508.03, Anne Arundel, MD",3010,347,1069,254,1941,399
14000US24003750804,"Census Tract 7508.04, Anne Arundel, MD",1519,239,1304,255,215,102
14000US24003750900,"Census Tract 7509, Anne Arundel, MD",1202,162,843,145,359,123
14000US24003751000,"Census Tract 7510, Anne Arundel, MD",1640,195,1487,208,153,62
14000US24003751102,"Census Tract 7511.02, Anne Arundel, MD",1842,346,1369,346,473,130
14000US24003751103,"Census Tract 7511.03, Anne Arundel, MD",2429,209,1667,272,762,289
14000US24003751200,"Census Tract 7512, Anne Arundel, MD",2198,210,1352,232,846,169
14000US24003751400,"Census Tract 7514, Anne Arundel, MD",1695,214,1582,213,113,63
14000US24003751500,"Census Tract 7515, Anne Arundel, MD",2910,359,1960,427,950,281
14000US24003751600,"Census Tract 7516, Anne Arundel, MD",2667,302,2601,308,66,51
14000US24003751700,"Census Tract 7517, Anne Arundel, MD",928,86,797,114,131,95
14000US24003980000,"Census Tract 9800, Anne Arundel, MD",0,14,0,14,0,14
14000US24003990000,"Census Tract 9900, Anne Arundel, MD",0,14,0,14,0,14
14000US24005400100,"Census Tract 4001, Baltimore, MD",2350,271,1122,189,1228,292
14000US24005400200,"Census Tract 4002, Baltimore, MD",1114,112,562,99,552,106
14000US24005400400,"Census Tract 4004, Baltimore, MD",2394,384,1949,256,445,272
14000US24005400500,"Census Tract 4005, Baltimore, MD",1000,91,973,93,27,22
14000US24005400600,"Census Tract 4006, Baltimore, MD",1266,293,798,192,468,228
14000US24005400701,"Census Tract 4007.01, Baltimore, MD",1535,196,723,145,812,170
14000US24005400702,"Census Tract 4007.02, Baltimore, MD",685,76,534,79,151,59
14000US24005400800,"Census Tract 4008, Baltimore, MD",1059,125,716,115,343,113
14000US24005400900,"Census Tract 4009, Baltimore, MD",750,92,525,67,225,105
14000US24005401000,"Census Tract 4010, Baltimore, MD",787,80,546,74,241,60
14000US24005401101,"Census Tract 4011.01, Baltimore, MD",2254,274,1520,246,734,247
14000US24005401102,"Census Tract 4011.02, Baltimore, MD",484,67,197,38,287,72
14000US24005401200,"Census Tract 4012, Baltimore, MD",1284,200,888,153,396,198
14000US24005401301,"Census Tract 4013.01, Baltimore, MD",1402,128,1177,122,225,108
14000US24005401302,"Census Tract 4013.02, Baltimore, MD",1482,206,798,169,684,171
14000US24005401400,"Census Tract 4014, Baltimore, MD",569,51,560,52,9,11
14000US24005401503,"Census Tract 4015.03, Baltimore, MD",2696,259,2216,254,480,137
14000US24005401504,"Census Tract 4015.04, Baltimore, MD",2228,329,1889,307,339,182
14000US24005401505,"Census Tract 4015.05, Baltimore, MD",1498,141,1124,145,374,94
14000US24005401506,"Census Tract 4015.06, Baltimore, MD",1827,139,1155,172,672,132
14000US24005401507,"Census Tract 4015.07, Baltimore, MD",2520,377,769,198,1751,422
14000US24005402201,"Census Tract 4022.01, Baltimore, MD",1170,172,987,171,183,84
14000US24005402202,"Census Tract 4022.02, Baltimore, MD",638,87,604,86,34,24
14000US24005402302,"Census Tract 4023.02, Baltimore, MD",2034,192,1282,212,752,174
14000US24005402303,"Census Tract 4023.03, Baltimore, MD",2535,300,1763,256,772,276
14000US24005402304,"Census Tract 4023.04, Baltimore, MD",1251,107,990,136,261,101
14000US24005402305,"Census Tract 4023.05, Baltimore, MD",1067,217,356,86,711,233
14000US24005402306,"Census Tract 4023.06, Baltimore, MD",1672,177,532,133,1140,150
14000US24005402307,"Census Tract 4023.07, Baltimore, MD",2414,269,675,268,1739,298
14000US24005402403,"Census Tract 4024.03, Baltimore, MD",870,120,788,99,82,84
14000US24005402404,"Census Tract 4024.04, Baltimore, MD",2417,255,1326,296,1091,323
14000US24005402405,"Census Tract 4024.05, Baltimore, MD",1432,169,747,177,685,199
14000US24005402407,"Census Tract 4024.07, Baltimore, MD",468,76,305,73,163,67
14000US24005402408,"Census Tract 4024.08, Baltimore, MD",1080,132,334,91,746,135
14000US24005402409,"Census Tract 4024.09, Baltimore, MD",1678,310,397,210,1281,280
14000US24005402503,"Census Tract 4025.03, Baltimore, MD",2348,267,586,186,1762,245
14000US24005402504,"Census Tract 4025.04, Baltimore, MD",1772,212,1592,188,180,102
14000US24005402505,"Census Tract 4025.05, Baltimore, MD",1349,159,618,183,731,133
14000US24005402506,"Census Tract 4025.06, Baltimore, MD",1816,263,1592,252,224,125
14000US24005402510,"Census Tract 4025.10, Baltimore, MD",1938,284,643,268,1295,294
14000US24005402511,"Census Tract 4025.11, Baltimore, MD",2382,356,1433,357,949,257
14000US24005402602,"Census Tract 4026.02, Baltimore, MD",759,116,649,115,110,58
14000US24005402603,"Census Tract 4026.03, Baltimore, MD",2588,295,2341,321,247,159
14000US24005402604,"Census Tract 4026.04, Baltimore, MD",2277,295,2102,299,175,156
14000US24005403100,"Census Tract 4031, Baltimore, MD",801,122,596,98,205,108
14000US24005403201,"Census Tract 4032.01, Baltimore, MD",1261,210,1185,218,76,50
14000US24005403202,"Census Tract 4032.02, Baltimore, MD",813,82,752,92,61,49
14000US24005403300,"Census Tract 4033, Baltimore, MD",1028,132,699,105,329,128
14000US24005403401,"Census Tract 4034.01, Baltimore, MD",1878,245,765,112,1113,272
14000US24005403402,"Census Tract 4034.02, Baltimore, MD",2395,342,1619,344,776,207
14000US24005403500,"Census Tract 4035, Baltimore, MD",1908,246,1280,146,628,268
14000US24005403601,"Census Tract 4036.01, Baltimore, MD",1768,171,1281,209,487,156
14000US24005403602,"Census Tract 4036.02, Baltimore, MD",2370,246,1409,238,961,248
14000US24005403702,"Census Tract 4037.02, Baltimore, MD",2172,233,913,227,1259,304
14000US24005403703,"Census Tract 4037.03, Baltimore, MD",1290,132,1080,153,210,77
14000US24005403704,"Census Tract 4037.04, Baltimore, MD",1926,318,1361,313,565,219
14000US24005403801,"Census Tract 4038.01, Baltimore, MD",574,46,546,46,28,21
14000US24005403802,"Census Tract 4038.02, Baltimore, MD",937,90,929,92,8,12
14000US24005403803,"Census Tract 4038.03, Baltimore, MD",1420,135,1324,147,96,53
14000US24005404101,"Census Tract 4041.01, Baltimore, MD",3240,281,2160,339,1080,283
14000US24005404102,"Census Tract 4041.02, Baltimore, MD",2159,302,1416,251,743,293
14000US24005404201,"Census Tract 4042.01, Baltimore, MD",2389,274,853,177,1536,336
14000US24005404202,"Census Tract 4042.02, Baltimore, MD",2975,365,460,215,2515,374
14000US24005404402,"Census Tract 4044.02, Baltimore, MD",2481,311,2181,254,300,225
14000US24005404403,"Census Tract 4044.03, Baltimore, MD",1995,222,995,232,1000,241
14000US24005404404,"Census Tract 4044.04, Baltimore, MD",2214,329,1666,277,548,189
14000US24005404501,"Census Tract 4045.01, Baltimore, MD",2444,302,1942,313,502,180
14000US24005404502,"Census Tract 4045.02, Baltimore, MD",1534,218,1063,205,471,129
14000US24005404600,"Census Tract 4046, Baltimore, MD",1116,171,944,165,172,73
14000US24005404800,"Census Tract 4048, Baltimore, MD",786,82,760,88,26,29
14000US24005404900,"Census Tract 4049, Baltimore, MD",1800,174,1479,159,321,85
14000US24005405000,"Census Tract 4050, Baltimore, MD",1682,186,1450,200,232,99
14000US24005406000,"Census Tract 4060, Baltimore, MD",2186,209,2147,212,39,47
14000US24005407001,"Census Tract 4070.01, Baltimore, MD",1129,74,1086,80,43,35
14000US24005407002,"Census Tract 4070.02, Baltimore, MD",2010,249,1874,245,136,74
14000US24005408100,"Census Tract 4081, Baltimore, MD",2559,353,1730,175,829,342
14000US24005408200,"Census Tract 4082, Baltimore, MD",705,75,590,79,115,57
14000US24005408302,"Census Tract 4083.02, Baltimore, MD",1172,154,1132,160,40,23
14000US24005408303,"Census Tract 4083.03, Baltimore, MD",1213,127,1203,128,10,15
14000US24005408304,"Census Tract 4083.04, Baltimore, MD",2245,282,1816,220,429,231
14000US24005408400,"Census Tract 4084, Baltimore, MD",722,85,280,42,442,85
14000US24005408502,"Census Tract 4085.02, Baltimore, MD",2031,231,1596,215,435,100
14000US24005408503,"Census Tract 4085.03, Baltimore, MD",1756,253,790,224,966,225
14000US24005408505,"Census Tract 4085.05, Baltimore, MD",1451,94,1031,116,420,93
14000US24005408506,"Census Tract 4085.06, Baltimore, MD",2392,233,166,97,2226,236
14000US24005408507,"Census Tract 4085.07, Baltimore, MD",3005,387,237,225,2768,309
14000US24005408601,"Census Tract 4086.01, Baltimore, MD",1549,153,1449,157,100,65
14000US24005408602,"Census Tract 4086.02, Baltimore, MD",740,85,720,91,20,19
14000US24005408702,"Census Tract 4087.02, Baltimore, MD",902,75,725,83,177,61
14000US24005408703,"Census Tract 4087.03, Baltimore, MD",2829,309,2115,246,714,294
14000US24005408704,"Census Tract 4087.04, Baltimore, MD",1952,164,1828,180,124,70
14000US24005408800,"Census Tract 4088, Baltimore, MD",975,109,614,115,361,56
14000US24005408900,"Census Tract 4089, Baltimore, MD",1092,146,1017,149,75,43
14000US24005410100,"Census Tract 4101, Baltimore, MD",2180,278,2130,277,50,46
14000US24005410200,"Census Tract 4102, Baltimore, MD",1731,141,1705,140,26,28
14000US24005411101,"Census Tract 4111.01, Baltimore, MD",853,152,723,75,130,141
14000US24005411102,"Census Tract 4111.02, Baltimore, MD",1199,155,1153,158,46,33
14000US24005411201,"Census Tract 4112.01, Baltimore, MD",1062,95,1012,106,50,43
14000US24005411202,"Census Tract 4112.02, Baltimore, MD",1474,185,1275,167,199,78
14000US24005411302,"Census Tract 4113.02, Baltimore, MD",1411,125,1202,107,209,95
14000US24005411303,"Census Tract 4113.03, Baltimore, MD",2553,290,1862,324,691,193
14000US24005411306,"Census Tract 4113.06, Baltimore, MD",2116,234,1657,214,459,203
14000US24005411307,"Census Tract 4113.07, Baltimore, MD",1463,217,827,149,636,230
14000US24005411308,"Census Tract 4113.08, Baltimore, MD",1584,200,1468,206,116,79
14000US24005411309,"Census Tract 4113.09, Baltimore, MD",3121,240,2795,275,326,134
14000US24005411404,"Census Tract 4114.04, Baltimore, MD",1252,157,1144,165,108,51
14000US24005411406,"Census Tract 4114.06, Baltimore, MD",1688,132,1558,146,130,58
14000US24005411408,"Census Tract 4114.08, Baltimore, MD",1480,189,541,140,939,177
14000US24005411409,"Census Tract 4114.09, Baltimore, MD",1575,105,1443,125,132,70
14000US24005411410,"Census Tract 4114.10, Baltimore, MD",1775,259,1593,267,182,93
14000US24005411411,"Census Tract 4114.11, Baltimore, MD",1193,186,912,190,281,127
14000US24005411412,"Census Tract 4114.12, Baltimore, MD",1491,229,612,258,879,215
14000US24005411413,"Census Tract 4114.13, Baltimore, MD",2114,429,729,252,1385,387
14000US24005420100,"Census Tract 4201, Baltimore, MD",1311,162,1089,187,222,130
14000US24005420200,"Census Tract 4202, Baltimore, MD",1571,213,1316,200,255,94
14000US24005420301,"Census Tract 4203.01, Baltimore, MD",1027,171,474,124,553,191
14000US24005420302,"Census Tract 4203.02, Baltimore, MD",931,124,549,139,382,89
14000US24005420303,"Census Tract 4203.03, Baltimore, MD",492,95,425,101,67,39
14000US24005420401,"Census Tract 4204.01, Baltimore, MD",2183,195,897,199,1286,257
14000US24005420402,"Census Tract 4204.02, Baltimore, MD",753,95,549,66,204,90
14000US24005420500,"Census Tract 4205, Baltimore, MD",1418,222,843,184,575,236
14000US24005420600,"Census Tract 4206, Baltimore, MD",1296,175,995,188,301,95
14000US24005420701,"Census Tract 4207.01, Baltimore, MD",1321,192,673,158,648,214
14000US24005420702,"Census Tract 4207.02, Baltimore, MD",824,90,664,101,160,82
14000US24005420800,"Census Tract 4208, Baltimore, MD",1264,167,1083,184,181,121
14000US24005420900,"Census Tract 4209, Baltimore, MD",1530,114,810,149,720,138
14000US24005421000,"Census Tract 4210, Baltimore, MD",1070,179,361,105,709,157
14000US24005421101,"Census Tract 4211.01, Baltimore, MD",1276,146,634,113,642,149
14000US24005421102,"Census Tract 4211.02, Baltimore, MD",1115,198,741,118,374,208
14000US24005421200,"Census Tract 4212, Baltimore, MD",784,111,687,118,97,53
14000US24005430101,"Census Tract 4301.01, Baltimore, MD",1977,187,688,227,1289,244
14000US24005430104,"Census Tract 4301.04, Baltimore, MD",1032,294,905,305,127,77
14000US24005430200,"Census Tract 4302, Baltimore, MD",1160,232,807,218,353,147
14000US24005430300,"Census Tract 4303, Baltimore, MD",2244,416,1323,356,921,379
14000US24005430400,"Census Tract 4304, Baltimore, MD",1712,235,1247,129,465,211
14000US24005430600,"Census Tract 4306, Baltimore, MD",931,101,875,107,56,43
14000US24005430700,"Census Tract 4307, Baltimore, MD",2060,252,1741,251,319,132
14000US24005430800,"Census Tract 4308, Baltimore, MD",1577,183,1198,162,379,166
14000US24005430900,"Census Tract 4309, Baltimore, MD",1856,211,795,219,1061,210
14000US24005440100,"Census Tract 4401, Baltimore, MD",1524,186,1448,184,76,50
14000US24005440200,"Census Tract 4402, Baltimore, MD",1055,106,750,157,305,117
14000US24005440300,"Census Tract 4403, Baltimore, MD",976,108,480,108,496,83
14000US24005440400,"Census Tract 4404, Baltimore, MD",2269,352,2067,339,202,117
14000US24005440500,"Census Tract 4405, Baltimore, MD",1328,173,1201,171,127,55
14000US24005440600,"Census Tract 4406, Baltimore, MD",933,93,734,94,199,53
14000US24005440701,"Census Tract 4407.01, Baltimore, MD",2952,442,1223,404,1729,271
14000US24005440702,"Census Tract 4407.02, Baltimore, MD",2088,219,1227,201,861,250
14000US24005440800,"Census Tract 4408, Baltimore, MD",1482,261,646,106,836,273
14000US24005440900,"Census Tract 4409, Baltimore, MD",1459,163,693,159,766,153
14000US24005441000,"Census Tract 4410, Baltimore, MD",1435,206,702,130,733,206
14000US24005441101,"Census Tract 4411.01, Baltimore, MD",877,182,803,183,74,39
14000US24005441102,"Census Tract 4411.02, Baltimore, MD",1966,262,1680,273,286,95
14000US24005450100,"Census Tract 4501, Baltimore, MD",1380,134,1141,139,239,124
14000US24005450200,"Census Tract 4502, Baltimore, MD",1230,145,1028,155,202,108
14000US24005450300,"Census Tract 4503, Baltimore, MD",1318,129,905,151,413,111
14000US24005450400,"Census Tract 4504, Baltimore, MD",852,91,658,84,194,52
14000US24005450501,"Census Tract 4505.01, Baltimore, MD",1750,223,1040,210,710,174
14000US24005450503,"Census Tract 4505.03, Baltimore, MD",2390,229,780,284,1610,205
14000US24005450504,"Census Tract 4505.04, Baltimore, MD",2767,283,283,240,2484,314
14000US24005450800,"Census Tract 4508, Baltimore, MD",1725,131,1071,182,654,156
14000US24005450900,"Census Tract 4509, Baltimore, MD",1707,135,1611,116,96,92
14000US24005451000,"Census Tract 4510, Baltimore, MD",666,61,569,61,97,46
14000US24005451100,"Census Tract 4511, Baltimore, MD",734,121,537,140,197,70
14000US24005451200,"Census Tract 4512, Baltimore, MD",1655,198,1433,215,222,97
14000US24005451300,"Census Tract 4513, Baltimore, MD",1352,210,685,179,667,162
14000US24005451401,"Census Tract 4514.01, Baltimore, MD",1411,272,857,311,554,162
14000US24005451402,"Census Tract 4514.02, Baltimore, MD",1802,291,744,238,1058,285
14000US24005451500,"Census Tract 4515, Baltimore, MD",1274,157,855,150,419,163
14000US24005451600,"Census Tract 4516, Baltimore, MD",842,116,565,99,277,100
14000US24005451701,"Census Tract 4517.01, Baltimore, MD",2566,248,1934,218,632,181
14000US24005451702,"Census Tract 4517.02, Baltimore, MD",678,80,655,77,23,28
14000US24005451801,"Census Tract 4518.01, Baltimore, MD",1897,223,1287,225,610,204
14000US24005451802,"Census Tract 4518.02, Baltimore, MD",1818,268,1533,264,285,151
14000US24005451803,"Census Tract 4518.03, Baltimore, MD",1765,175,1331,181,434,143
14000US24005451900,"Census Tract 4519, Baltimore, MD",1090,164,955,176,135,81
14000US24005452000,"Census Tract 4520, Baltimore, MD",1039,121,836,139,203,73
14000US24005452100,"Census Tract 4521, Baltimore, MD",1260,210,1140,210,120,59
14000US24005452300,"Census Tract 4523, Baltimore, MD",1195,286,673,315,522,149
14000US24005452400,"Census Tract 4524, Baltimore, MD",1273,155,1153,150,120,61
14000US24005452500,"Census Tract 4525, Baltimore, MD",1255,117,930,138,325,132
14000US24005490100,"Census Tract 4901, Baltimore, MD",1448,112,1437,111,11,17
14000US24005490200,"Census Tract 4902, Baltimore, MD",1093,143,1059,144,34,30
14000US24005490302,"Census Tract 4903.02, Baltimore, MD",1253,214,782,208,471,112
14000US24005490303,"Census Tract 4903.03, Baltimore, MD",1155,285,247,226,908,182
14000US24005490304,"Census Tract 4903.04, Baltimore, MD",2444,334,347,134,2097,334
14000US24005490400,"Census Tract 4904, Baltimore, MD",654,86,620,90,34,23
14000US24005490500,"Census Tract 4905, Baltimore, MD",1431,158,1170,152,261,78
14000US24005490601,"Census Tract 4906.01, Baltimore, MD",841,104,762,109,79,31
14000US24005490602,"Census Tract 4906.02, Baltimore, MD",1307,160,774,165,533,111
14000US24005490603,"Census Tract 4906.03, Baltimore, MD",972,82,727,92,245,73
14000US24005490605,"Census Tract 4906.05, Baltimore, MD",191,56,0,19,191,56
14000US24005490701,"Census Tract 4907.01, Baltimore, MD",602,65,413,55,189,49
14000US24005490703,"Census Tract 4907.03, Baltimore, MD",1610,266,919,265,691,129
14000US24005490800,"Census Tract 4908, Baltimore, MD",1194,151,742,89,452,125
14000US24005490900,"Census Tract 4909, Baltimore, MD",2756,369,949,202,1807,378
14000US24005491000,"Census Tract 4910, Baltimore, MD",781,72,748,74,33,31
14000US24005491100,"Census Tract 4911, Baltimore, MD",1243,127,977,143,266,79
14000US24005491201,"Census Tract 4912.01, Baltimore, MD",873,103,623,98,250,80
14000US24005491202,"Census Tract 4912.02, Baltimore, MD",773,77,572,71,201,72
14000US24005491300,"Census Tract 4913, Baltimore, MD",1434,177,475,143,959,176
14000US24005491401,"Census Tract 4914.01, Baltimore, MD",2127,292,336,151,1791,315
14000US24005491402,"Census Tract 4914.02, Baltimore, MD",1081,141,794,135,287,152
14000US24005491500,"Census Tract 4915, Baltimore, MD",1819,241,1225,275,594,176
14000US24005491600,"Census Tract 4916, Baltimore, MD",1162,226,808,231,354,130
14000US24005491701,"Census Tract 4917.01, Baltimore, MD",1774,189,1035,155,739,147
14000US24005491900,"Census Tract 4919, Baltimore, MD",717,94,598,84,119,74
14000US24005492001,"Census Tract 4920.01, Baltimore, MD",568,56,404,80,164,75
14000US24005492002,"Census Tract 4920.02, Baltimore, MD",1539,158,1201,166,338,130
14000US24005492101,"Census Tract 4921.01, Baltimore, MD",1670,237,845,203,825,185
14000US24005492102,"Census Tract 4921.02, Baltimore, MD",878,104,745,113,133,68
14000US24005492200,"Census Tract 4922, Baltimore, MD",1927,246,1328,257,599,181
14000US24005492300,"Census Tract 4923, Baltimore, MD",1405,299,1179,302,226,104
14000US24005492401,"Census Tract 4924.01, Baltimore, MD",1417,192,941,169,476,146
14000US24005492402,"Census Tract 4924.02, Baltimore, MD",3103,269,1746,283,1357,353
14000US24005492500,"Census Tract 4925, Baltimore, MD",12,11,12,11,0,14
14000US24005492600,"Census Tract 4926, Baltimore, MD",1511,138,863,159,648,119
14000US24005492700,"Census Tract 4927, Baltimore, MD",1211,312,401,113,810,286
14000US24005980100,"Census Tract 9801, Baltimore, MD",0,14,0,14,0,14
14000US24005980200,"Census Tract 9802, Baltimore, MD",0,14,0,14,0,14
14000US24009860103,"Census Tract 8601.03, Calvert, MD",2056,208,1845,152,211,174
14000US24009860200,"Census Tract 8602, Calvert, MD",2019,280,1918,281,101,101
14000US24009860300,"Census Tract 8603, Calvert, MD",1507,181,1371,183,136,69
14000US24009860402,"Census Tract 8604.02, Calvert, MD",1403,163,1242,170,161,76
14000US24009860403,"Census Tract 8604.03, Calvert, MD",1526,193,1239,181,287,168
14000US24009860404,"Census Tract 8604.04, Calvert, MD",2734,246,2204,266,530,158
14000US24009860501,"Census Tract 8605.01, Calvert, MD",2255,197,2236,200,19,32
14000US24009860502,"Census Tract 8605.02, Calvert, MD",1213,163,1136,164,77,61
14000US24009860600,"Census Tract 8606, Calvert, MD",2173,224,1907,258,266,139
14000US24009860701,"Census Tract 8607.01, Calvert, MD",1323,205,886,220,437,121
14000US24009860702,"Census Tract 8607.02, Calvert, MD",1070,142,710,128,360,142
14000US24009860703,"Census Tract 8607.03, Calvert, MD",1592,218,1458,235,134,77
14000US24009860801,"Census Tract 8608.01, Calvert, MD",2386,299,2258,306,128,80
14000US24009860901,"Census Tract 8609.01, Calvert, MD",2219,316,1705,327,514,165
14000US24009860902,"Census Tract 8609.02, Calvert, MD",902,146,695,113,207,113
14000US24009861003,"Census Tract 8610.03, Calvert, MD",2324,231,2030,223,294,138
14000US24009861004,"Census Tract 8610.04, Calvert, MD",2452,237,2246,253,206,118
14000US24009861100,"Census Tract 8611, Calvert, MD",2331,244,2098,248,233,94
14000US24009990100,"Census Tract 9901, Calvert, MD",0,14,0,14,0,14
14000US24011955000,"Census Tract 9550, Caroline, MD",964,123,844,120,120,55
14000US24011955100,"Census Tract 9551, Caroline, MD",2139,161,1614,162,525,130
14000US24011955201,"Census Tract 9552.01, Caroline, MD",1455,113,1082,127,373,92
14000US24011955202,"Census Tract 9552.02, Caroline, MD",834,108,667,93,167,62
14000US24011955301,"Census Tract 9553.01, Caroline, MD",1401,168,1086,172,315,123
14000US24011955302,"Census Tract 9553.02, Caroline, MD",1282,167,665,133,617,150
14000US24011955400,"Census Tract 9554, Caroline, MD",755,87,660,92,95,48
14000US24011955500,"Census Tract 9555, Caroline, MD",1452,119,1149,117,303,107
14000US24011955600,"Census Tract 9556, Caroline, MD",1899,215,986,158,913,176
14000US24013501001,"Census Tract 5010.01, Carroll, MD",1844,180,1657,196,187,92
14000US24013501002,"Census Tract 5010.02, Carroll, MD",2059,266,1423,238,636,323
14000US24013502000,"Census Tract 5020, Carroll, MD",1554,153,1323,183,231,94
14000US24013503000,"Census Tract 5030, Carroll, MD",1998,346,1667,192,331,282
14000US24013504100,"Census Tract 5041, Carroll, MD",1933,166,1852,165,81,43
14000US24013504201,"Census Tract 5042.01, Carroll, MD",2088,237,1972,238,116,81
14000US24013504202,"Census Tract 5042.02, Carroll, MD",2270,229,2127,234,143,72
14000US24013505101,"Census Tract 5051.01, Carroll, MD",1323,116,1306,115,17,19
14000US24013505102,"Census Tract 5051.02, Carroll, MD",2008,212,1830,206,178,81
14000US24013505203,"Census Tract 5052.03, Carroll, MD",1261,177,1060,197,201,94
14000US24013505205,"Census Tract 5052.05, Carroll, MD",1200,103,1078,122,122,60
14000US24013505206,"Census Tract 5052.06, Carroll, MD",1189,88,1165,86,24,27
14000US24013505207,"Census Tract 5052.07, Carroll, MD",1273,78,945,105,328,76
14000US24013505208,"Census Tract 5052.08, Carroll, MD",1735,149,1128,159,607,184
14000US24013506101,"Census Tract 5061.01, Carroll, MD",1761,230,1636,229,125,64
14000US24013506102,"Census Tract 5061.02, Carroll, MD",1650,237,1517,245,133,74
14000US24013506200,"Census Tract 5062, Carroll, MD",2133,215,1808,223,325,150
14000US24013507500,"Census Tract 5075, Carroll, MD",1322,134,1201,117,121,90
14000US24013507601,"Census Tract 5076.01, Carroll, MD",1722,175,1366,167,356,108
14000US24013507602,"Census Tract 5076.02, Carroll, MD",1847,194,1309,206,538,138
14000US24013507702,"Census Tract 5077.02, Carroll, MD",1722,174,1157,178,565,146
14000US24013507703,"Census Tract 5077.03, Carroll, MD",1548,226,828,180,720,169
14000US24013507704,"Census Tract 5077.04, Carroll, MD",2325,256,1909,209,416,229
14000US24013507801,"Census Tract 5078.01, Carroll, MD",2633,330,1375,375,1258,240
14000US24013507802,"Census Tract 5078.02, Carroll, MD",1922,280,1543,179,379,229
14000US24013508103,"Census Tract 5081.03, Carroll, MD",3257,385,2791,391,466,136
14000US24013508200,"Census Tract 5082, Carroll, MD",2664,210,2286,240,378,148
14000US24013509001,"Census Tract 5090.01, Carroll, MD",1734,213,1531,188,203,116
14000US24013509002,"Census Tract 5090.02, Carroll, MD",929,119,855,113,74,54
14000US24013510000,"Census Tract 5100, Carroll, MD",466,50,363,63,103,51
14000US24013511000,"Census Tract 5110, Carroll, MD",1503,171,1403,168,100,61
14000US24013512000,"Census Tract 5120, Carroll, MD",643,94,474,90,169,42
14000US24013513001,"Census Tract 5130.01, Carroll, MD",1840,147,1703,151,137,52
14000US24013513002,"Census Tract 5130.02, Carroll, MD",1835,181,1765,192,70,62
14000US24013514100,"Census Tract 5141, Carroll, MD",1202,133,1162,126,40,43
14000US24013514201,"Census Tract 5142.01, Carroll, MD",1881,161,1676,156,205,125
14000US24013514202,"Census Tract 5142.02, Carroll, MD",1213,92,1046,106,167,72
14000US24015030100,"Census Tract 301, Cecil, MD",2224,273,1921,291,303,102
14000US24015030200,"Census Tract 302, Cecil, MD",2105,199,1802,227,303,112
14000US24015030400,"Census Tract 304, Cecil, MD",2036,345,671,308,1365,239
14000US24015030501,"Census Tract 305.01, Cecil, MD",1430,172,1305,169,125,53
14000US24015030503,"Census Tract 305.03, Cecil, MD",2250,231,1194,227,1056,238
14000US24015030505,"Census Tract 305.05, Cecil, MD",1383,206,1082,214,301,108
14000US24015030507,"Census Tract 305.07, Cecil, MD",1657,176,644,133,1013,166
14000US24015030508,"Census Tract 305.08, Cecil, MD",1708,239,1169,190,539,277
14000US24015030601,"Census Tract 306.01, Cecil, MD",1525,212,1409,206,116,76
14000US24015030602,"Census Tract 306.02, Cecil, MD",2156,208,1405,201,751,198
14000US24015030700,"Census Tract 307, Cecil, MD",1809,190,1724,192,85,48
14000US24015030903,"Census Tract 309.03, Cecil, MD",2256,299,1416,254,840,262
14000US24015030904,"Census Tract 309.04, Cecil, MD",2869,493,2743,482,126,81
14000US24015030905,"Census Tract 309.05, Cecil, MD",975,126,845,119,130,75
14000US24015030907,"Census Tract 309.07, Cecil, MD",2043,228,1472,264,571,188
14000US24015030908,"Census Tract 309.08, Cecil, MD",2208,214,1733,208,475,182
14000US24015031201,"Census Tract 312.01, Cecil, MD",2248,225,1953,211,295,116
14000US24015031202,"Census Tract 312.02, Cecil, MD",2114,254,1503,199,611,186
14000US24015031301,"Census Tract 313.01, Cecil, MD",1187,120,1106,114,81,46
14000US24015031302,"Census Tract 313.02, Cecil, MD",2352,223,1761,206,591,163
14000US24015031400,"Census Tract 314, Cecil, MD",1637,212,1394,210,243,127
14000US24017850101,"Census Tract 8501.01, Charles, MD",2529,228,2426,238,103,58
14000US24017850102,"Census Tract 8501.02, Charles, MD",855,92,814,88,41,29
14000US24017850201,"Census Tract 8502.01, Charles, MD",340,68,222,70,118,43
14000US24017850202,"Census Tract 8502.02, Charles, MD",1982,301,1396,241,586,257
14000US24017850300,"Census Tract 8503, Charles, MD",740,117,674,109,66,41
14000US24017850400,"Census Tract 8504, Charles, MD",1230,145,1066,124,164,84
14000US24017850500,"Census Tract 8505, Charles, MD",969,122,906,119,63,42
14000US24017850600,"Census Tract 8506, Charles, MD",1627,179,1524,180,103,89
14000US24017850706,"Census Tract 8507.06, Charles, MD",1963,185,1882,197,81,60
14000US24017850708,"Census Tract 8507.08, Charles, MD",1906,254,1670,252,236,122
14000US24017850709,"Census Tract 8507.09, Charles, MD",2924,300,1788,312,1136,306
14000US24017850710,"Census Tract 8507.10, Charles, MD",2117,296,1798,330,319,111
14000US24017850711,"Census Tract 8507.11, Charles, MD",1899,149,1483,172,416,163
14000US24017850712,"Census Tract 8507.12, Charles, MD",1820,134,1728,140,92,65
14000US24017850713,"Census Tract 8507.13, Charles, MD",3057,272,2851,302,206,144
14000US24017850801,"Census Tract 8508.01, Charles, MD",1589,204,1460,201,129,71
14000US24017850802,"Census Tract 8508.02, Charles, MD",2333,342,1794,243,539,302
14000US24017850901,"Census Tract 8509.01, Charles, MD",2270,227,1076,236,1194,291
14000US24017850902,"Census Tract 8509.02, Charles, MD",1689,194,1544,208,145,69
14000US24017850904,"Census Tract 8509.04, Charles, MD",4762,344,3930,407,832,278
14000US24017850905,"Census Tract 8509.05, Charles, MD",1409,96,1248,141,161,88
14000US24017850906,"Census Tract 8509.06, Charles, MD",2187,210,1036,189,1151,192
14000US24017851001,"Census Tract 8510.01, Charles, MD",1342,168,1217,173,125,69
14000US24017851003,"Census Tract 8510.03, Charles, MD",1529,190,1417,213,112,79
14000US24017851004,"Census Tract 8510.04, Charles, MD",2260,260,1572,265,688,207
14000US24017851100,"Census Tract 8511, Charles, MD",988,142,857,134,131,96
14000US24017851200,"Census Tract 8512, Charles, MD",1838,233,1504,244,334,115
14000US24017851301,"Census Tract 8513.01, Charles, MD",1568,165,1480,169,88,47
14000US24017851302,"Census Tract 8513.02, Charles, MD",1439,116,1290,83,149,110
14000US24017851401,"Census Tract 8514.01, Charles, MD",1004,152,969,150,35,36
14000US24017851402,"Census Tract 8514.02, Charles, MD",1293,191,1199,198,94,99
14000US24017851403,"Census Tract 8514.03, Charles, MD",641,123,559,141,82,55
14000US24017851501,"Census Tract 8515.01, Charles, MD",1710,192,1061,180,649,189
14000US24017851502,"Census Tract 8515.02, Charles, MD",2390,270,1459,173,931,267
14000US24017990000,"Census Tract 9900, Charles, MD",0,14,0,14,0,14
14000US24019970100,"Census Tract 9701, Dorchester, MD",1191,145,1000,152,191,92
14000US24019970200,"Census Tract 9702, Dorchester, MD",2093,230,1788,222,305,93
14000US24019970300,"Census Tract 9703, Dorchester, MD",1716,154,1420,135,296,93
14000US24019970400,"Census Tract 9704, Dorchester, MD",1562,204,884,175,678,166
14000US24019970500,"Census Tract 9705, Dorchester, MD",1609,206,380,130,1229,208
14000US24019970600,"Census Tract 9706, Dorchester, MD",2091,277,885,204,1206,273
14000US24019970702,"Census Tract 9707.02, Dorchester, MD",1776,222,1298,185,478,197
14000US24019970804,"Census Tract 9708.04, Dorchester, MD",777,93,707,92,70,39
14000US24019970900,"Census Tract 9709, Dorchester, MD",509,85,475,91,34,24
14000US24019990000,"Census Tract 9900, Dorchester, MD",0,14,0,14,0,14
14000US24021740200,"Census Tract 7402, Frederick, MD",1926,168,1718,183,208,71
14000US24021750100,"Census Tract 7501, Frederick, MD",904,108,455,101,449,104
14000US24021750200,"Census Tract 7502, Frederick, MD",1122,169,498,125,624,151
14000US24021750300,"Census Tract 7503, Frederick, MD",914,123,372,105,542,108
14000US24021750504,"Census Tract 7505.04, Frederick, MD",2191,292,1082,199,1109,342
14000US24021750505,"Census Tract 7505.05, Frederick, MD",2759,221,1402,257,1357,183
14000US24021750506,"Census Tract 7505.06, Frederick, MD",1501,213,1376,212,125,110
14000US24021750507,"Census Tract 7505.07, Frederick, MD",1592,279,574,188,1018,269
14000US24021750508,"Census Tract 7505.08, Frederick, MD",1792,241,392,142,1400,264
14000US24021750600,"Census Tract 7506, Frederick, MD",1039,125,896,114,143,56
14000US24021750701,"Census Tract 7507.01, Frederick, MD",1891,152,1552,172,339,121
14000US24021750702,"Census Tract 7507.02, Frederick, MD",1929,236,828,220,1101,225
14000US24021750801,"Census Tract 7508.01, Frederick, MD",1756,380,505,128,1251,357
14000US24021750802,"Census Tract 7508.02, Frederick, MD",2768,254,2223,296,545,144
14000US24021750804,"Census Tract 7508.04, Frederick, MD",1086,254,953,240,133,78
14000US24021750805,"Census Tract 7508.05, Frederick, MD",1724,196,1295,174,429,180
14000US24021751001,"Census Tract 7510.01, Frederick, MD",734,106,519,77,215,74
14000US24021751002,"Census Tract 7510.02, Frederick, MD",2367,407,1305,291,1062,359
14000US24021751003,"Census Tract 7510.03, Frederick, MD",2198,270,1236,252,962,231
14000US24021751004,"Census Tract 7510.04, Frederick, MD",2181,165,1579,167,602,123
14000US24021751201,"Census Tract 7512.01, Frederick, MD",2032,250,1708,261,324,99
14000US24021751202,"Census Tract 7512.02, Frederick, MD",2822,283,2281,319,541,157
14000US24021751203,"Census Tract 7512.03, Frederick, MD",756,73,714,71,42,30
14000US24021751301,"Census Tract 7513.01, Frederick, MD",1999,191,1395,147,604,140
14000US24021751302,"Census Tract 7513.02, Frederick, MD",1265,224,1183,223,82,44
14000US24021751600,"Census Tract 7516, Frederick, MD",1066,110,969,122,97,63
14000US24021751701,"Census Tract 7517.01, Frederick, MD",910,163,846,166,64,44
14000US24021751702,"Census Tract 7517.02, Frederick, MD",1402,162,1246,195,156,84
14000US24021751801,"Census Tract 7518.01, Frederick, MD",1786,121,1657,133,129,68
14000US24021751802,"Census Tract 7518.02, Frederick, MD",1348,173,1220,173,128,80
14000US24021751902,"Census Tract 7519.02, Frederick, MD",2101,191,1837,176,264,124
14000US24021751903,"Census Tract 7519.03, Frederick, MD",2352,285,2267,288,85,60
14000US24021751904,"Census Tract 7519.04, Frederick, MD",1549,127,1472,138,77,54
14000US24021751905,"Census Tract 7519.05, Frederick, MD",1446,198,1284,196,162,77
14000US24021751906,"Census Tract 7519.06, Frederick, MD",840,89,775,107,65,61
14000US24021752001,"Census Tract 7520.01, Frederick, MD",1701,154,1607,182,94,55
14000US24021752101,"Census Tract 7521.01, Frederick, MD",1163,91,1118,93,45,47
14000US24021752102,"Census Tract 7521.02, Frederick, MD",2268,164,2180,154,88,86
14000US24021752201,"Census Tract 7522.01, Frederick, MD",838,126,753,125,85,37
14000US24021752202,"Census Tract 7522.02, Frederick, MD",1234,92,978,118,256,95
14000US24021752205,"Census Tract 7522.05, Frederick, MD",1041,181,961,196,80,64
14000US24021752206,"Census Tract 7522.06, Frederick, MD",2178,185,1626,201,552,188
14000US24021752301,"Census Tract 7523.01, Frederick, MD",2575,327,2085,337,490,135
14000US24021752302,"Census Tract 7523.02, Frederick, MD",1480,180,1235,177,245,78
14000US24021752303,"Census Tract 7523.03, Frederick, MD",1148,178,1071,174,77,48
14000US24021752501,"Census Tract 7525.01, Frederick, MD",1907,199,1614,183,293,93
14000US24021752502,"Census Tract 7525.02, Frederick, MD",1001,123,906,118,95,54
14000US24021752601,"Census Tract 7526.01, Frederick, MD",1581,120,1297,118,284,113
14000US24021752602,"Census Tract 7526.02, Frederick, MD",862,88,778,73,84,75
14000US24021752603,"Census Tract 7526.03, Frederick, MD",1456,189,1366,197,90,61
14000US24021752801,"Census Tract 7528.01, Frederick, MD",823,57,716,65,107,57
14000US24021752802,"Census Tract 7528.02, Frederick, MD",1263,130,1168,144,95,51
14000US24021752900,"Census Tract 7529, Frederick, MD",1234,195,944,111,290,189
14000US24021753001,"Census Tract 7530.01, Frederick, MD",2101,224,1561,236,540,137
14000US24021753002,"Census Tract 7530.02, Frederick, MD",981,97,810,111,171,70
14000US24021765100,"Census Tract 7651, Frederick, MD",1950,209,1293,230,657,169
14000US24021766800,"Census Tract 7668, Frederick, MD",1418,153,1062,147,356,129
14000US24021767500,"Census Tract 7675, Frederick, MD",1040,188,947,174,93,62
14000US24021767600,"Census Tract 7676, Frederick, MD",1186,90,950,102,236,73
14000US24021770700,"Census Tract 7707, Frederick, MD",1374,142,1229,146,145,83
14000US24021772200,"Census Tract 7722, Frederick, MD",832,139,350,80,482,139
14000US24021773500,"Census Tract 7735, Frederick, MD",1623,174,1314,178,309,107
14000US24021775302,"Census Tract 7753.02, Frederick, MD",2088,160,1953,160,135,75
14000US24021775400,"Census Tract 7754, Frederick, MD",1625,187,1321,180,304,102
14000US24021775600,"Census Tract 7756, Frederick, MD",1788,145,1622,139,166,74
14000US24023000100,"Census Tract 1, Garrett, MD",1814,177,1494,175,320,89
14000US24023000200,"Census Tract 2, Garrett, MD",1607,168,1268,155,339,114
14000US24023000300,"Census Tract 3, Garrett, MD",1038,153,976,147,62,45
14000US24023000400,"Census Tract 4, Garrett, MD",1147,156,959,153,188,63
14000US24023000501,"Census Tract 5.01, Garrett, MD",817,146,705,126,112,70
14000US24023000502,"Census Tract 5.02, Garrett, MD",1285,219,998,193,287,125
14000US24023000601,"Census Tract 6.01, Garrett, MD",1901,229,1340,170,561,169
14000US24023000602,"Census Tract 6.02, Garrett, MD",645,90,637,92,8,13
14000US24023000700,"Census Tract 7, Garrett, MD",2311,193,1803,197,508,118
14000US24025301102,"Census Tract 3011.02, Harford, MD",1383,118,1304,147,79,57
14000US24025301105,"Census Tract 3011.05, Harford, MD",1393,134,1325,137,68,41
14000US24025301106,"Census Tract 3011.06, Harford, MD",1535,131,1322,139,213,102
14000US24025301107,"Census Tract 3011.07, Harford, MD",1801,159,551,126,1250,185
14000US24025301108,"Census Tract 3011.08, Harford, MD",1431,258,1363,261,68,84
14000US24025301201,"Census Tract 3012.01, Harford, MD",746,91,679,94,67,43
14000US24025301202,"Census Tract 3012.02, Harford, MD",3081,354,2721,389,360,128
14000US24025301204,"Census Tract 3012.04, Harford, MD",1557,126,1099,125,458,131
14000US24025301205,"Census Tract 3012.05, Harford, MD",1941,270,1745,279,196,76
14000US24025301301,"Census Tract 3013.01, Harford, MD",1929,256,1659,184,270,230
14000US24025301302,"Census Tract 3013.02, Harford, MD",3062,337,1596,305,1466,353
14000US24025301401,"Census Tract 3014.01, Harford, MD",3118,329,2222,296,896,292
14000US24025301402,"Census Tract 3014.02, Harford, MD",1024,126,898,139,126,72
14000US24025301601,"Census Tract 3016.01, Harford, MD",2517,344,1573,353,944,302
14000US24025301602,"Census Tract 3016.02, Harford, MD",2937,250,2653,302,284,152
14000US24025301703,"Census Tract 3017.03, Harford, MD",1996,257,1761,275,235,114
14000US24025301704,"Census Tract 3017.04, Harford, MD",1388,133,886,151,502,133
14000US24025301705,"Census Tract 3017.05, Harford, MD",1031,78,750,105,281,75
14000US24025301706,"Census Tract 3017.06, Harford, MD",1180,106,876,130,304,108
14000US24025301707,"Census Tract 3017.07, Harford, MD",1693,307,1542,328,151,102
14000US24025302100,"Census Tract 3021, Harford, MD",788,114,743,110,45,29
14000US24025302200,"Census Tract 3022, Harford, MD",1335,159,1074,155,261,105
14000US24025302400,"Census Tract 3024, Harford, MD",1774,164,1065,145,709,169
14000US24025302801,"Census Tract 3028.01, Harford, MD",1507,165,1199,159,308,95
14000US24025302802,"Census Tract 3028.02, Harford, MD",2038,157,1105,217,933,164
14000US24025302901,"Census Tract 3029.01, Harford, MD",984,167,473,125,511,152
14000US24025302902,"Census Tract 3029.02, Harford, MD",2077,288,1554,249,523,204
14000US24025303101,"Census Tract 3031.01, Harford, MD",2173,236,1982,250,191,94
14000US24025303102,"Census Tract 3031.02, Harford, MD",842,53,811,60,31,30
14000US24025303201,"Census Tract 3032.01, Harford, MD",1983,228,1883,230,100,74
14000US24025303203,"Census Tract 3032.03, Harford, MD",1249,105,1066,106,183,93
14000US24025303204,"Census Tract 3032.04, Harford, MD",1835,144,1457,150,378,94
14000US24025303205,"Census Tract 3032.05, Harford, MD",598,144,589,145,9,11
14000US24025303206,"Census Tract 3032.06, Harford, MD",1230,98,1184,108,46,34
14000US24025303300,"Census Tract 3033, Harford, MD",2448,245,2235,250,213,78
14000US24025303400,"Census Tract 3034, Harford, MD",1816,155,1700,168,116,64
14000US24025303501,"Census Tract 3035.01, Harford, MD",2854,220,2149,258,705,133
14000US24025303502,"Census Tract 3035.02, Harford, MD",1216,87,1165,93,51,30
14000US24025303602,"Census Tract 3036.02, Harford, MD",1378,186,1291,191,87,41
14000US24025303603,"Census Tract 3036.03, Harford, MD",2196,161,2039,171,157,124
14000US24025303605,"Census Tract 3036.05, Harford, MD",2745,346,1966,326,779,220
14000US24025303606,"Census Tract 3036.06, Harford, MD",1071,136,1054,140,17,18
14000US24025303700,"Census Tract 3037, Harford, MD",1612,173,1376,167,236,118
14000US24025303801,"Census Tract 3038.01, Harford, MD",1457,178,1027,131,430,150
14000US24025303802,"Census Tract 3038.02, Harford, MD",811,92,665,95,146,51
14000US24025303803,"Census Tract 3038.03, Harford, MD",2213,176,1478,192,735,185
14000US24025303900,"Census Tract 3039, Harford, MD",948,117,607,115,341,76
14000US24025304101,"Census Tract 3041.01, Harford, MD",1739,190,1558,167,181,116
14000US24025304102,"Census Tract 3041.02, Harford, MD",1373,126,1292,132,81,48
14000US24025304201,"Census Tract 3042.01, Harford, MD",2494,275,2237,272,257,127
14000US24025304202,"Census Tract 3042.02, Harford, MD",2204,178,2094,182,110,73
14000US24025305100,"Census Tract 3051, Harford, MD",2717,282,2419,265,298,161
14000US24025305200,"Census Tract 3052, Harford, MD",1087,142,1008,142,79,59
14000US24025305300,"Census Tract 3053, Harford, MD",787,73,616,67,171,85
14000US24025306100,"Census Tract 3061, Harford, MD",2028,222,918,193,1110,204
14000US24025306200,"Census Tract 3062, Harford, MD",1037,147,521,124,516,138
14000US24025306300,"Census Tract 3063, Harford, MD",1179,161,1122,165,57,43
14000US24025306400,"Census Tract 3064, Harford, MD",2816,231,2671,244,145,101
14000US24025306500,"Census Tract 3065, Harford, MD",889,139,9,14,880,141
14000US24027601103,"Census Tract 6011.03, Howard, MD",2080,162,1995,173,85,67
14000US24027601104,"Census Tract 6011.04, Howard, MD",2110,243,1978,186,132,155
14000US24027601105,"Census Tract 6011.05, Howard, MD",2221,214,1673,232,548,159
14000US24027601107,"Census Tract 6011.07, Howard, MD",1952,207,903,175,1049,150
14000US24027601108,"Census Tract 6011.08, Howard, MD",1463,126,1110,133,353,90
14000US24027601203,"Census Tract 6012.03, Howard, MD",3091,274,1566,253,1525,341
14000US24027601204,"Census Tract 6012.04, Howard, MD",3046,370,1881,346,1165,231
14000US24027601205,"Census Tract 6012.05, Howard, MD",1876,116,1107,144,769,132
14000US24027601206,"Census Tract 6012.06, Howard, MD",1304,122,1150,128,154,94
14000US24027602100,"Census Tract 6021, Howard, MD",2850,284,2800,283,50,51
14000US24027602201,"Census Tract 6022.01, Howard, MD",1233,146,886,87,347,125
14000US24027602202,"Census Tract 6022.02, Howard, MD",1935,165,1467,168,468,107
14000US24027602302,"Census Tract 6023.02, Howard, MD",2139,212,1485,208,654,186
14000US24027602303,"Census Tract 6023.03, Howard, MD",1482,203,1426,201,56,64
14000US24027602304,"Census Tract 6023.04, Howard, MD",1584,141,1545,143,39,31
14000US24027602305,"Census Tract 6023.05, Howard, MD",1453,161,1148,131,305,94
14000US24027602306,"Census Tract 6023.06, Howard, MD",2353,352,1824,348,529,186
14000US24027602600,"Census Tract 6026, Howard, MD",2929,351,1084,195,1845,335
14000US24027602700,"Census Tract 6027, Howard, MD",2006,164,1954,167,52,40
14000US24027602800,"Census Tract 6028, Howard, MD",2202,221,1625,242,577,200
14000US24027602900,"Census Tract 6029, Howard, MD",2181,285,462,139,1719,298
14000US24027603001,"Census Tract 6030.01, Howard, MD",2297,241,1906,141,391,216
14000US24027603003,"Census Tract 6030.03, Howard, MD",1474,192,1392,198,82,51
14000US24027603004,"Census Tract 6030.04, Howard, MD",2731,300,2335,216,396,252
14000US24027604001,"Census Tract 6040.01, Howard, MD",2164,219,1921,206,243,133
14000US24027604003,"Census Tract 6040.03, Howard, MD",1348,125,1307,123,41,39
14000US24027604004,"Census Tract 6040.04, Howard, MD",1448,211,1398,206,50,42
14000US24027605103,"Census Tract 6051.03, Howard, MD",1806,277,1760,261,46,49
14000US24027605104,"Census Tract 6051.04, Howard, MD",1808,194,1690,195,118,57
14000US24027605105,"Census Tract 6051.05, Howard, MD",2764,276,2387,283,377,127
14000US24027605106,"Census Tract 6051.06, Howard, MD",1418,142,1349,145,69,47
14000US24027605401,"Census Tract 6054.01, Howard, MD",2245,215,1050,198,1195,179
14000US24027605403,"Census Tract 6054.03, Howard, MD",1675,255,1151,244,524,184
14000US24027605404,"Census Tract 6054.04, Howard, MD",2554,360,424,157,2130,316
14000US24027605502,"Census Tract 6055.02, Howard, MD",1812,247,1223,223,589,166
14000US24027605503,"Census Tract 6055.03, Howard, MD",2216,153,1425,191,791,154
14000US24027605504,"Census Tract 6055.04, Howard, MD",769,122,724,122,45,28
14000US24027605505,"Census Tract 6055.05, Howard, MD",1948,186,1751,187,197,94
14000US24027605601,"Census Tract 6056.01, Howard, MD",3238,405,2200,363,1038,212
14000US24027605602,"Census Tract 6056.02, Howard, MD",3109,255,2330,299,779,195
14000US24027606601,"Census Tract 6066.01, Howard, MD",1281,262,1164,273,117,76
14000US24027606603,"Census Tract 6066.03, Howard, MD",3092,311,1880,307,1212,264
14000US24027606604,"Census Tract 6066.04, Howard, MD",1583,133,1238,162,345,115
14000US24027606606,"Census Tract 6066.06, Howard, MD",2183,232,963,252,1220,196
14000US24027606607,"Census Tract 6066.07, Howard, MD",1610,141,1465,136,145,87
14000US24027606701,"Census Tract 6067.01, Howard, MD",908,79,812,60,96,60
14000US24027606704,"Census Tract 6067.04, Howard, MD",2665,288,1558,199,1107,245
14000US24027606706,"Census Tract 6067.06, Howard, MD",2104,186,1514,213,590,194
14000US24027606708,"Census Tract 6067.08, Howard, MD",2447,260,1661,198,786,209
14000US24027606803,"Census Tract 6068.03, Howard, MD",2435,238,1324,227,1111,261
14000US24027606804,"Census Tract 6068.04, Howard, MD",1209,76,821,89,388,121
14000US24027606805,"Census Tract 6068.05, Howard, MD",1756,188,1552,158,204,140
14000US24027606807,"Census Tract 6068.07, Howard, MD",743,85,732,86,11,18
14000US24027606808,"Census Tract 6068.08, Howard, MD",1988,245,1673,270,315,122
14000US24027606901,"Census Tract 6069.01, Howard, MD",2483,291,1596,207,887,331
14000US24027606904,"Census Tract 6069.04, Howard, MD",1536,163,889,125,647,172
14000US24027606905,"Census Tract 6069.05, Howard, MD",3159,380,1900,347,1259,222
14000US24027606906,"Census Tract 6069.06, Howard, MD",2147,230,1723,262,424,183
14000US24027606907,"Census Tract 6069.07, Howard, MD",2423,359,843,234,1580,372
14000US24029950100,"Census Tract 9501, Kent, MD",1551,195,1162,150,389,130
14000US24029950200,"Census Tract 9502, Kent, MD",1945,183,1626,175,319,133
14000US24029950300,"Census Tract 9503, Kent, MD",2390,203,1174,195,1216,244
14000US24029950400,"Census Tract 9504, Kent, MD",1494,155,1303,170,191,88
14000US24029950500,"Census Tract 9505, Kent, MD",1150,166,882,162,268,105
14000US24029990000,"Census Tract 9900, Kent, MD",0,14,0,14,0,14
14000US24031700101,"Census Tract 7001.01, Montgomery, MD",1579,169,1578,169,1,3
14000US24031700103,"Census Tract 7001.03, Montgomery, MD",1843,217,1805,217,38,28
14000US24031700104,"Census Tract 7001.04, Montgomery, MD",1682,148,1401,134,281,138
14000US24031700105,"Census Tract 7001.05, Montgomery, MD",2119,230,1867,247,252,119
14000US24031700204,"Census Tract 7002.04, Montgomery, MD",874,176,794,177,80,44
14000US24031700206,"Census Tract 7002.06, Montgomery, MD",1928,219,1868,224,60,56
14000US24031700207,"Census Tract 7002.07, Montgomery, MD",1850,158,1569,186,281,103
14000US24031700208,"Census Tract 7002.08, Montgomery, MD",840,96,707,110,133,62
14000US24031700209,"Census Tract 7002.09, Montgomery, MD",1598,248,1509,235,89,85
14000US24031700210,"Census Tract 7002.10, Montgomery, MD",2775,227,2107,255,668,174
14000US24031700306,"Census Tract 7003.06, Montgomery, MD",2373,193,1948,253,425,200
14000US24031700308,"Census Tract 7003.08, Montgomery, MD",2551,230,1880,225,671,168
14000US24031700309,"Census Tract 7003.09, Montgomery, MD",2403,214,1311,278,1092,223
14000US24031700310,"Census Tract 7003.10, Montgomery, MD",2829,251,1631,269,1198,197
14000US24031700313,"Census Tract 7003.13, Montgomery, MD",1523,150,696,162,827,133
14000US24031700314,"Census Tract 7003.14, Montgomery, MD",1125,149,1052,157,73,51
14000US24031700315,"Census Tract 7003.15, Montgomery, MD",1744,255,1637,271,107,59
14000US24031700316,"Census Tract 7003.16, Montgomery, MD",1278,178,1133,192,145,102
14000US24031700317,"Census Tract 7003.17, Montgomery, MD",2172,331,2029,347,143,71
14000US24031700318,"Census Tract 7003.18, Montgomery, MD",1108,274,1063,287,45,40
14000US24031700400,"Census Tract 7004, Montgomery, MD",835,106,715,114,120,49
14000US24031700500,"Census Tract 7005, Montgomery, MD",2542,232,2354,217,188,117
14000US24031700604,"Census Tract 7006.04, Montgomery, MD",2314,214,2184,234,130,120
14000US24031700606,"Census Tract 7006.06, Montgomery, MD",1275,131,1196,137,79,45
14000US24031700608,"Census Tract 7006.08, Montgomery, MD",1799,178,1738,198,61,55
14000US24031700610,"Census Tract 7006.10, Montgomery, MD",725,128,703,130,22,13
14000US24031700611,"Census Tract 7006.11, Montgomery, MD",1732,227,1582,250,150,68
14000US24031700613,"Census Tract 7006.13, Montgomery, MD",2065,182,1377,167,688,162
14000US24031700614,"Census Tract 7006.14, Montgomery, MD",2287,297,1347,268,940,226
14000US24031700615,"Census Tract 7006.15, Montgomery, MD",990,107,963,110,27,21
14000US24031700616,"Census Tract 7006.16, Montgomery, MD",1813,279,1618,294,195,81
14000US24031700617,"Census Tract 7006.17, Montgomery, MD",705,58,624,61,81,42
14000US24031700618,"Census Tract 7006.18, Montgomery, MD",1715,230,1528,235,187,83
14000US24031700706,"Census Tract 7007.06, Montgomery, MD",1613,165,687,114,926,164
14000US24031700710,"Census Tract 7007.10, Montgomery, MD",2065,238,1688,307,377,162
14000US24031700711,"Census Tract 7007.11, Montgomery, MD",2415,171,1822,174,593,164
14000US24031700713,"Census Tract 7007.13, Montgomery, MD",1912,166,624,108,1288,167
14000US24031700715,"Census Tract 7007.15, Montgomery, MD",1845,272,1588,287,257,115
14000US24031700718,"Census Tract 7007.18, Montgomery, MD",3028,299,1303,219,1725,267
14000US24031700720,"Census Tract 7007.20, Montgomery, MD",1032,111,763,100,269,108
14000US24031700721,"Census Tract 7007.21, Montgomery, MD",1594,235,682,247,912,229
14000US24031700723,"Census Tract 7007.23, Montgomery, MD",2014,204,413,155,1601,180
14000US24031700724,"Census Tract 7007.24, Montgomery, MD",1112,135,160,81,952,130
14000US24031700725,"Census Tract 7007.25, Montgomery, MD",1826,168,571,163,1255,206
14000US24031700726,"Census Tract 7007.26, Montgomery, MD",1468,359,792,241,676,320
14000US24031700727,"Census Tract 7007.27, Montgomery, MD",528,79,306,71,222,60
14000US24031700728,"Census Tract 7007.28, Montgomery, MD",846,131,219,69,627,135
14000US24031700729,"Census Tract 7007.29, Montgomery, MD",908,205,767,205,141,57
14000US24031700730,"Census Tract 7007.30, Montgomery, MD",1744,125,1276,177,468,136
14000US24031700731,"Census Tract 7007.31, Montgomery, MD",1479,155,478,119,1001,195
14000US24031700732,"Census Tract 7007.32, Montgomery, MD",943,183,500,116,443,165
14000US24031700733,"Census Tract 7007.33, Montgomery, MD",2160,206,916,227,1244,174
14000US24031700810,"Census Tract 7008.10, Montgomery, MD",1904,294,1652,301,252,104
14000US24031700811,"Census Tract 7008.11, Montgomery, MD",1600,266,1087,157,513,240
14000US24031700812,"Census Tract 7008.12, Montgomery, MD",1677,235,1248,157,429,192
14000US24031700813,"Census Tract 7008.13, Montgomery, MD",2009,359,1460,223,549,348
14000US24031700815,"Census Tract 7008.15, Montgomery, MD",2570,243,2152,258,418,180
14000US24031700818,"Census Tract 7008.18, Montgomery, MD",2463,183,608,217,1855,196
14000US24031700819,"Census Tract 7008.19, Montgomery, MD",2257,283,1988,294,269,115
14000US24031700820,"Census Tract 7008.20, Montgomery, MD",1187,212,301,58,886,214
14000US24031700822,"Census Tract 7008.22, Montgomery, MD",671,82,367,96,304,66
14000US24031700823,"Census Tract 7008.23, Montgomery, MD",1036,118,922,123,114,55
14000US24031700824,"Census Tract 7008.24, Montgomery, MD",976,99,883,107,93,60
14000US24031700826,"Census Tract 7008.26, Montgomery, MD",2648,340,1698,343,950,178
14000US24031700828,"Census Tract 7008.28, Montgomery, MD",768,78,706,77,62,36
14000US24031700829,"Census Tract 7008.29, Montgomery, MD",1203,123,1081,119,122,56
14000US24031700830,"Census Tract 7008.30, Montgomery, MD",966,145,207,86,759,138
14000US24031700832,"Census Tract 7008.32, Montgomery, MD",901,61,750,86,151,66
14000US24031700833,"Census Tract 7008.33, Montgomery, MD",1370,172,968,212,402,167
14000US24031700834,"Census Tract 7008.34, Montgomery, MD",1749,255,1189,243,560,151
14000US24031700835,"Census Tract 7008.35, Montgomery, MD",1418,177,1253,130,165,147
14000US24031700836,"Census Tract 7008.36, Montgomery, MD",615,172,304,74,311,170
14000US24031700837,"Census Tract 7008.37, Montgomery, MD",2541,269,971,186,1570,315
14000US24031700838,"Census Tract 7008.38, Montgomery, MD",2226,242,361,129,1865,246
14000US24031700839,"Census Tract 7008.39, Montgomery, MD",2535,298,855,296,1680,201
14000US24031700901,"Census Tract 7009.01, Montgomery, MD",3007,395,601,159,2406,414
14000US24031700902,"Census Tract 7009.02, Montgomery, MD",1411,237,1080,252,331,92
14000US24031700903,"Census Tract 7009.03, Montgomery, MD",626,59,230,62,396,58
14000US24031700904,"Census Tract 7009.04, Montgomery, MD",1818,141,129,56,1689,157
14000US24031700905,"Census Tract 7009.05, Montgomery, MD",1489,189,400,150,1089,148
14000US24031701001,"Census Tract 7010.01, Montgomery, MD",2202,361,1772,370,430,132
14000US24031701002,"Census Tract 7010.02, Montgomery, MD",1588,152,1085,148,503,103
14000US24031701004,"Census Tract 7010.04, Montgomery, MD",1717,166,1274,133,443,128
14000US24031701005,"Census Tract 7010.05, Montgomery, MD",1103,104,887,113,216,77
14000US24031701006,"Census Tract 7010.06, Montgomery, MD",1794,266,1601,279,193,80
14000US24031701007,"Census Tract 7010.07, Montgomery, MD",1441,178,524,108,917,188
14000US24031701101,"Census Tract 7011.01, Montgomery, MD",1588,173,1322,187,266,101
14000US24031701102,"Census Tract 7011.02, Montgomery, MD",2049,229,1465,269,584,171
14000US24031701201,"Census Tract 7012.01, Montgomery, MD",2439,355,1256,212,1183,368
14000US24031701202,"Census Tract 7012.02, Montgomery, MD",993,120,926,125,67,35
14000US24031701205,"Census Tract 7012.05, Montgomery, MD",2396,212,1886,207,510,194
14000US24031701206,"Census Tract 7012.06, Montgomery, MD",2062,108,1795,148,267,110
14000US24031701210,"Census Tract 7012.10, Montgomery, MD",1260,72,1181,95,79,64
14000US24031701211,"Census Tract 7012.11, Montgomery, MD",2408,166,1223,222,1185,198
14000US24031701212,"Census Tract 7012.12, Montgomery, MD",895,92,788,69,107,61
14000US24031701214,"Census Tract 7012.14, Montgomery, MD",2021,277,826,283,1195,160
14000US24031701215,"Census Tract 7012.15, Montgomery, MD",2502,308,1177,206,1325,339
14000US24031701216,"Census Tract 7012.16, Montgomery, MD",3514,242,908,198,2606,270
14000US24031701218,"Census Tract 7012.18, Montgomery, MD",1458,111,289,100,1169,123
14000US24031701219,"Census Tract 7012.19, Montgomery, MD",1902,312,6,10,1896,312
14000US24031701220,"Census Tract 7012.20, Montgomery, MD",1129,109,1061,118,68,41
14000US24031701221,"Census Tract 7012.21, Montgomery, MD",1700,191,899,150,801,156
14000US24031701222,"Census Tract 7012.22, Montgomery, MD",1730,201,1110,197,620,154
14000US24031701223,"Census Tract 7012.23, Montgomery, MD",1554,174,629,110,925,169
14000US24031701303,"Census Tract 7013.03, Montgomery, MD",1358,201,1315,207,43,35
14000US24031701304,"Census Tract 7013.04, Montgomery, MD",2144,292,2046,297,98,74
14000US24031701306,"Census Tract 7013.06, Montgomery, MD",929,84,890,88,39,33
14000US24031701307,"Census Tract 7013.07, Montgomery, MD",1516,247,1415,252,101,53
14000US24031701308,"Census Tract 7013.08, Montgomery, MD",1517,146,1403,147,114,54
14000US24031701312,"Census Tract 7013.12, Montgomery, MD",1983,164,1753,195,230,133
14000US24031701313,"Census Tract 7013.13, Montgomery, MD",1136,76,1004,88,132,64
14000US24031701314,"Census Tract 7013.14, Montgomery, MD",1019,104,858,133,161,76
14000US24031701315,"Census Tract 7013.15, Montgomery, MD",1626,194,1196,200,430,115
14000US24031701316,"Census Tract 7013.16, Montgomery, MD",2163,345,1982,344,181,86
14000US24031701317,"Census Tract 7013.17, Montgomery, MD",1390,101,1336,112,54,38
14000US24031701407,"Census Tract 7014.07, Montgomery, MD",1867,213,1738,186,129,117
14000US24031701408,"Census Tract 7014.08, Montgomery, MD",1889,101,1777,107,112,93
14000US24031701409,"Census Tract 7014.09, Montgomery, MD",1459,233,1410,235,49,32
14000US24031701414,"Census Tract 7014.14, Montgomery, MD",2396,200,1763,201,633,230
14000US24031701415,"Census Tract 7014.15, Montgomery, MD",2566,332,2198,342,368,197
14000US24031701417,"Census Tract 7014.17, Montgomery, MD",2751,293,737,173,2014,355
14000US24031701418,"Census Tract 7014.18, Montgomery, MD",1138,127,958,133,180,75
14000US24031701422,"Census Tract 7014.22, Montgomery, MD",1137,179,0,14,1137,179
14000US24031701423,"Census Tract 7014.23, Montgomery, MD",1964,273,941,259,1023,194
14000US24031701424,"Census Tract 7014.24, Montgomery, MD",927,103,829,87,98,64
14000US24031701425,"Census Tract 7014.25, Montgomery, MD",1759,172,953,169,806,167
14000US24031701426,"Census Tract 7014.26, Montgomery, MD",1931,246,1385,277,546,129
14000US24031701427,"Census Tract 7014.27, Montgomery, MD",922,73,762,97,160,71
14000US24031701503,"Census Tract 7015.03, Montgomery, MD",2257,237,1842,245,415,187
14000US24031701505,"Census Tract 7015.05, Montgomery, MD",2602,313,1238,287,1364,240
14000US24031701506,"Census Tract 7015.06, Montgomery, MD",1753,182,1573,149,180,123
14000US24031701507,"Census Tract 7015.07, Montgomery, MD",1986,360,1334,135,652,350
14000US24031701508,"Census Tract 7015.08, Montgomery, MD",1568,250,303,95,1265,268
14000US24031701509,"Census Tract 7015.09, Montgomery, MD",2331,159,509,130,1822,196
14000US24031701601,"Census Tract 7016.01, Montgomery, MD",751,87,68,26,683,87
14000US24031701602,"Census Tract 7016.02, Montgomery, MD",1864,249,686,122,1178,253
14000US24031701701,"Census Tract 7017.01, Montgomery, MD",1555,197,812,151,743,164
14000US24031701702,"Census Tract 7017.02, Montgomery, MD",1045,135,340,130,705,120
14000US24031701703,"Census Tract 7017.03, Montgomery, MD",1284,170,693,117,591,189
14000US24031701704,"Census Tract 7017.04, Montgomery, MD",1050,133,761,134,289,105
14000US24031701800,"Census Tract 7018, Montgomery, MD",1787,182,859,89,928,185
14000US24031701900,"Census Tract 7019, Montgomery, MD",1318,192,219,98,1099,192
14000US24031702000,"Census Tract 7020, Montgomery, MD",1703,224,752,169,951,213
14000US24031702101,"Census Tract 7021.01, Montgomery, MD",1912,176,1139,162,773,190
14000US24031702102,"Census Tract 7021.02, Montgomery, MD",1159,149,1078,149,81,53
14000US24031702200,"Census Tract 7022, Montgomery, MD",1586,170,1439,167,147,75
14000US24031702301,"Census Tract 7023.01, Montgomery, MD",1353,151,419,130,934,125
14000US24031702302,"Census Tract 7023.02, Montgomery, MD",1862,262,1033,147,829,270
14000US24031702401,"Census Tract 7024.01, Montgomery, MD",1049,137,878,138,171,66
14000US24031702402,"Census Tract 7024.02, Montgomery, MD",2076,240,820,203,1256,211
14000US24031702501,"Census Tract 7025.01, Montgomery, MD",2433,198,534,169,1899,236
14000US24031702502,"Census Tract 7025.02, Montgomery, MD",1073,175,192,83,881,168
14000US24031702503,"Census Tract 7025.03, Montgomery, MD",2688,280,218,122,2470,300
14000US24031702602,"Census Tract 7026.02, Montgomery, MD",2307,252,477,154,1830,241
14000US24031702603,"Census Tract 7026.03, Montgomery, MD",1092,133,66,43,1026,135
14000US24031702604,"Census Tract 7026.04, Montgomery, MD",1784,289,0,14,1784,289
14000US24031702700,"Census Tract 7027, Montgomery, MD",2479,283,1252,173,1227,334
14000US24031702800,"Census Tract 7028, Montgomery, MD",2675,382,1315,278,1360,368
14000US24031702900,"Census Tract 7029, Montgomery, MD",2232,256,1579,196,653,190
14000US24031703000,"Census Tract 7030, Montgomery, MD",703,83,603,90,100,50
14000US24031703100,"Census Tract 7031, Montgomery, MD",1586,160,1344,178,242,94
14000US24031703201,"Census Tract 7032.01, Montgomery, MD",2250,337,1887,305,363,203
14000US24031703202,"Census Tract 7032.02, Montgomery, MD",2041,218,1722,172,319,209
14000US24031703206,"Census Tract 7032.06, Montgomery, MD",1468,168,1015,141,453,164
14000US24031703207,"Census Tract 7032.07, Montgomery, MD",1711,145,794,146,917,128
14000US24031703208,"Census Tract 7032.08, Montgomery, MD",1553,170,1423,186,130,75
14000US24031703209,"Census Tract 7032.09, Montgomery, MD",2499,301,1622,359,877,300
14000US24031703210,"Census Tract 7032.10, Montgomery, MD",1309,210,1245,209,64,52
14000US24031703213,"Census Tract 7032.13, Montgomery, MD",2487,288,584,204,1903,363
14000US24031703214,"Census Tract 7032.14, Montgomery, MD",2637,331,674,163,1963,335
14000US24031703215,"Census Tract 7032.15, Montgomery, MD",1041,108,586,77,455,114
14000US24031703216,"Census Tract 7032.16, Montgomery, MD",2231,355,1916,238,315,262
14000US24031703218,"Census Tract 7032.18, Montgomery, MD",1470,234,1160,232,310,108
14000US24031703219,"Census Tract 7032.19, Montgomery, MD",2300,241,1849,263,451,167
14000US24031703220,"Census Tract 7032.20, Montgomery, MD",1836,166,1172,147,664,140
14000US24031703221,"Census Tract 7032.21, Montgomery, MD",1628,181,1419,182,209,97
14000US24031703222,"Census Tract 7032.22, Montgomery, MD",1548,155,701,143,847,187
14000US24031703223,"Census Tract 7032.23, Montgomery, MD",1883,144,1700,144,183,114
14000US24031703301,"Census Tract 7033.01, Montgomery, MD",1419,177,1349,178,70,54
14000US24031703302,"Census Tract 7033.02, Montgomery, MD",1338,217,1053,181,285,177
14000US24031703401,"Census Tract 7034.01, Montgomery, MD",1468,119,1161,118,307,122
14000US24031703402,"Census Tract 7034.02, Montgomery, MD",1074,189,938,200,136,81
14000US24031703403,"Census Tract 7034.03, Montgomery, MD",950,74,788,87,162,82
14000US24031703404,"Census Tract 7034.04, Montgomery, MD",910,103,719,126,191,64
14000US24031703501,"Census Tract 7035.01, Montgomery, MD",2148,178,1348,232,800,151
14000US24031703502,"Census Tract 7035.02, Montgomery, MD",1156,152,831,117,325,133
14000US24031703601,"Census Tract 7036.01, Montgomery, MD",1873,306,1569,297,304,97
14000US24031703602,"Census Tract 7036.02, Montgomery, MD",984,162,928,161,56,31
14000US24031703701,"Census Tract 7037.01, Montgomery, MD",1192,161,1006,171,186,55
14000US24031703702,"Census Tract 7037.02, Montgomery, MD",1317,219,1033,246,284,134
14000US24031703800,"Census Tract 7038, Montgomery, MD",2169,203,393,109,1776,229
14000US24031703901,"Census Tract 7039.01, Montgomery, MD",1096,122,980,133,116,62
14000US24031703902,"Census Tract 7039.02, Montgomery, MD",2783,317,1546,231,1237,322
14000US24031704000,"Census Tract 7040, Montgomery, MD",2468,278,1572,186,896,294
14000US24031704100,"Census Tract 7041, Montgomery, MD",1615,196,1394,129,221,158
14000US24031704200,"Census Tract 7042, Montgomery, MD",828,131,434,47,394,125
14000US24031704300,"Census Tract 7043, Montgomery, MD",1300,128,1148,124,152,61
14000US24031704401,"Census Tract 7044.01, Montgomery, MD",1143,87,1045,84,98,44
14000US24031704403,"Census Tract 7044.03, Montgomery, MD",951,100,624,111,327,97
14000US24031704404,"Census Tract 7044.04, Montgomery, MD",2084,209,1585,217,499,123
14000US24031704501,"Census Tract 7045.01, Montgomery, MD",1096,85,973,86,123,67
14000US24031704502,"Census Tract 7045.02, Montgomery, MD",988,89,873,89,115,48
14000US24031704503,"Census Tract 7045.03, Montgomery, MD",1385,179,1291,188,94,57
14000US24031704600,"Census Tract 7046, Montgomery, MD",1872,175,1517,162,355,116
14000US24031704700,"Census Tract 7047, Montgomery, MD",1338,163,1231,160,107,53
14000US24031704803,"Census Tract 7048.03, Montgomery, MD",2382,148,832,158,1550,177
14000US24031704804,"Census Tract 7048.04, Montgomery, MD",1250,118,471,104,779,117
14000US24031704805,"Census Tract 7048.05, Montgomery, MD",1582,161,331,84,1251,165
14000US24031704806,"Census Tract 7048.06, Montgomery, MD",2557,216,149,69,2408,198
14000US24031705000,"Census Tract 7050, Montgomery, MD",1806,199,1206,148,600,143
14000US24031705100,"Census Tract 7051, Montgomery, MD",2021,175,1640,114,381,134
14000US24031705200,"Census Tract 7052, Montgomery, MD",1139,117,1108,117,31,25
14000US24031705300,"Census Tract 7053, Montgomery, MD",669,80,651,76,18,13
14000US24031705400,"Census Tract 7054, Montgomery, MD",986,67,931,74,55,38
14000US24031705501,"Census Tract 7055.01, Montgomery, MD",1176,130,197,57,979,125
14000US24031705502,"Census Tract 7055.02, Montgomery, MD",1620,226,1322,178,298,163
14000US24031705601,"Census Tract 7056.01, Montgomery, MD",1149,230,1100,234,49,36
14000US24031705602,"Census Tract 7056.02, Montgomery, MD",2467,200,1373,187,1094,202
14000US24031705701,"Census Tract 7057.01, Montgomery, MD",1657,142,1170,139,487,110
14000US24031705702,"Census Tract 7057.02, Montgomery, MD",1686,167,1505,183,181,79
14000US24031705800,"Census Tract 7058, Montgomery, MD",2274,171,1942,193,332,113
14000US24031705901,"Census Tract 7059.01, Montgomery, MD",1440,121,1286,125,154,59
14000US24031705902,"Census Tract 7059.02, Montgomery, MD",1426,128,1242,114,184,101
14000US24031705903,"Census Tract 7059.03, Montgomery, MD",1679,262,1366,162,313,208
14000US24031706005,"Census Tract 7060.05, Montgomery, MD",1549,217,1332,103,217,189
14000US24031706007,"Census Tract 7060.07, Montgomery, MD",2306,191,2241,199,65,60
14000US24031706008,"Census Tract 7060.08, Montgomery, MD",1851,308,1750,311,101,54
14000US24031706009,"Census Tract 7060.09, Montgomery, MD",1698,126,1589,147,109,82
14000US24031706010,"Census Tract 7060.10, Montgomery, MD",1076,122,882,110,194,127
14000US24031706011,"Census Tract 7060.11, Montgomery, MD",1809,131,1735,133,74,47
14000US24031706012,"Census Tract 7060.12, Montgomery, MD",1844,215,953,193,891,183
14000US24031706013,"Census Tract 7060.13, Montgomery, MD",946,54,912,59,34,34
14000US24033800102,"Census Tract 8001.02, Prince George's, MD",1460,253,532,173,928,201
14000US24033800103,"Census Tract 8001.03, Prince George's, MD",948,137,160,75,788,137
14000US24033800105,"Census Tract 8001.05, Prince George's, MD",1361,126,876,126,485,144
14000US24033800106,"Census Tract 8001.06, Prince George's, MD",1250,199,1062,193,188,125
14000US24033800108,"Census Tract 8001.08, Prince George's, MD",1844,184,561,171,1283,207
14000US24033800109,"Census Tract 8001.09, Prince George's, MD",1315,169,648,119,667,163
14000US24033800203,"Census Tract 8002.03, Prince George's, MD",1620,222,1561,230,59,44
14000US24033800206,"Census Tract 8002.06, Prince George's, MD",1726,214,874,128,852,203
14000US24033800209,"Census Tract 8002.09, Prince George's, MD",1669,152,235,92,1434,161
14000US24033800210,"Census Tract 8002.10, Prince George's, MD",1189,161,259,83,930,173
14000US24033800211,"Census Tract 8002.11, Prince George's, MD",1309,156,229,100,1080,191
14000US24033800212,"Census Tract 8002.12, Prince George's, MD",2788,264,1334,223,1454,232
14000US24033800213,"Census Tract 8002.13, Prince George's, MD",1628,150,1036,117,592,147
14000US24033800216,"Census Tract 8002.16, Prince George's, MD",1465,164,1118,167,347,133
14000US24033800217,"Census Tract 8002.17, Prince George's, MD",1691,191,899,133,792,193
14000US24033800218,"Census Tract 8002.18, Prince George's, MD",2390,240,651,145,1739,278
14000US24033800401,"Census Tract 8004.01, Prince George's, MD",864,69,852,71,12,15
14000US24033800402,"Census Tract 8004.02, Prince George's, MD",1908,182,1699,214,209,109
14000US24033800403,"Census Tract 8004.03, Prince George's, MD",1349,135,1269,136,80,45
14000US24033800408,"Census Tract 8004.08, Prince George's, MD",2283,215,2127,234,156,106
14000US24033800409,"Census Tract 8004.09, Prince George's, MD",2342,290,2218,302,124,96
14000US24033800410,"Census Tract 8004.10, Prince George's, MD",1772,156,1689,132,83,90
14000US24033800411,"Census Tract 8004.11, Prince George's, MD",1506,176,1256,138,250,168
14000US24033800412,"Census Tract 8004.12, Prince George's, MD",1351,194,910,199,441,132
14000US24033800413,"Census Tract 8004.13, Prince George's, MD",1469,149,880,146,589,143
14000US24033800504,"Census Tract 8005.04, Prince George's, MD",1673,159,1490,139,183,105
14000US24033800505,"Census Tract 8005.05, Prince George's, MD",936,86,886,90,50,36
14000US24033800507,"Census Tract 8005.07, Prince George's, MD",1314,166,801,156,513,107
14000US24033800511,"Census Tract 8005.11, Prince George's, MD",1985,181,1645,179,340,118
14000US24033800513,"Census Tract 8005.13, Prince George's, MD",2338,241,2210,240,128,90
14000US24033800514,"Census Tract 8005.14, Prince George's, MD",2193,186,1988,211,205,124
14000US24033800515,"Census Tract 8005.15, Prince George's, MD",1981,338,1440,346,541,144
14000US24033800516,"Census Tract 8005.16, Prince George's, MD",1678,160,952,156,726,208
14000US24033800517,"Census Tract 8005.17, Prince George's, MD",1992,241,1796,170,196,209
14000US24033800518,"Census Tract 8005.18, Prince George's, MD",1232,86,1232,86,0,14
14000US24033800519,"Census Tract 8005.19, Prince George's, MD",1464,170,1384,189,80,45
14000US24033800520,"Census Tract 8005.20, Prince George's, MD",1094,84,507,88,587,122
14000US24033800521,"Census Tract 8005.21, Prince George's, MD",3183,256,2907,314,276,259
14000US24033800522,"Census Tract 8005.22, Prince George's, MD",1360,228,1205,273,155,125
14000US24033800605,"Census Tract 8006.05, Prince George's, MD",1622,145,1413,123,209,117
14000US24033800606,"Census Tract 8006.06, Prince George's, MD",2124,230,1520,209,604,234
14000US24033800607,"Census Tract 8006.07, Prince George's, MD",2136,186,1864,225,272,102
14000US24033800608,"Census Tract 8006.08, Prince George's, MD",2842,202,2735,239,107,110
14000US24033800609,"Census Tract 8006.09, Prince George's, MD",1471,187,1404,190,67,44
14000US24033800701,"Census Tract 8007.01, Prince George's, MD",3131,205,2841,242,290,197
14000US24033800704,"Census Tract 8007.04, Prince George's, MD",2164,304,1899,360,265,115
14000US24033800705,"Census Tract 8007.05, Prince George's, MD",1643,205,1463,229,180,57
14000US24033800706,"Census Tract 8007.06, Prince George's, MD",1353,151,1239,171,114,89
14000US24033800707,"Census Tract 8007.07, Prince George's, MD",1391,176,1150,160,241,126
14000US24033800800,"Census Tract 8008, Prince George's, MD",1313,147,1203,165,110,70
14000US24033800900,"Census Tract 8009, Prince George's, MD",578,147,459,120,119,92
14000US24033801003,"Census Tract 8010.03, Prince George's, MD",2266,238,2226,235,40,35
14000US24033801004,"Census Tract 8010.04, Prince George's, MD",1761,150,1708,162,53,43
14000US24033801005,"Census Tract 8010.05, Prince George's, MD",1334,104,1320,105,14,24
14000US24033801006,"Census Tract 8010.06, Prince George's, MD",1477,248,1357,178,120,184
14000US24033801105,"Census Tract 8011.05, Prince George's, MD",412,77,9,13,403,78
14000US24033801106,"Census Tract 8011.06, Prince George's, MD",458,82,0,14,458,82
14000US24033801207,"Census Tract 8012.07, Prince George's, MD",1557,168,1490,172,67,68
14000US24033801208,"Census Tract 8012.08, Prince George's, MD",1832,277,1730,276,102,86
14000US24033801209,"Census Tract 8012.09, Prince George's, MD",1515,131,1497,132,18,19
14000US24033801210,"Census Tract 8012.10, Prince George's, MD",1653,273,1340,117,313,287
14000US24033801211,"Census Tract 8012.11, Prince George's, MD",1009,109,971,120,38,45
14000US24033801212,"Census Tract 8012.12, Prince George's, MD",1149,206,1033,208,116,76
14000US24033801213,"Census Tract 8012.13, Prince George's, MD",1449,301,1361,293,88,72
14000US24033801214,"Census Tract 8012.14, Prince George's, MD",1567,122,1225,140,342,113
14000US24033801215,"Census Tract 8012.15, Prince George's, MD",985,164,900,173,85,50
14000US24033801216,"Census Tract 8012.16, Prince George's, MD",1252,133,1031,177,221,123
14000US24033801217,"Census Tract 8012.17, Prince George's, MD",1130,128,1007,110,123,89
14000US24033801302,"Census Tract 8013.02, Prince George's, MD",969,139,925,143,44,35
14000US24033801305,"Census Tract 8013.05, Prince George's, MD",2072,163,1845,206,227,107
14000US24033801307,"Census Tract 8013.07, Prince George's, MD",1321,84,1139,91,182,79
14000US24033801308,"Census Tract 8013.08, Prince George's, MD",1253,155,1225,154,28,35
14000US24033801309,"Census Tract 8013.09, Prince George's, MD",1363,150,1319,159,44,47
14000US24033801310,"Census Tract 8013.10, Prince George's, MD",2468,219,2468,219,0,19
14000US24033801311,"Census Tract 8013.11, Prince George's, MD",2593,157,2549,158,44,51
14000US24033801312,"Census Tract 8013.12, Prince George's, MD",1603,347,1475,345,128,109
14000US24033801313,"Census Tract 8013.13, Prince George's, MD",1084,122,941,128,143,73
14000US24033801404,"Census Tract 8014.04, Prince George's, MD",2804,240,1681,315,1123,269
14000US24033801405,"Census Tract 8014.05, Prince George's, MD",1575,206,858,187,717,174
14000US24033801406,"Census Tract 8014.06, Prince George's, MD",1505,225,812,216,693,151
14000US24033801407,"Census Tract 8014.07, Prince George's, MD",2496,381,2064,393,432,169
14000US24033801408,"Census Tract 8014.08, Prince George's, MD",1485,123,755,142,730,164
14000US24033801409,"Census Tract 8014.09, Prince George's, MD",1005,147,644,163,361,88
14000US24033801410,"Census Tract 8014.10, Prince George's, MD",1282,158,1108,164,174,95
14000US24033801411,"Census Tract 8014.11, Prince George's, MD",1057,107,952,127,105,76
14000US24033801500,"Census Tract 8015, Prince George's, MD",763,133,687,117,76,54
14000US24033801600,"Census Tract 8016, Prince George's, MD",1124,200,420,133,704,187
14000US24033801701,"Census Tract 8017.01, Prince George's, MD",1778,213,806,207,972,211
14000US24033801702,"Census Tract 8017.02, Prince George's, MD",1783,206,446,170,1337,228
14000US24033801704,"Census Tract 8017.04, Prince George's, MD",2344,421,491,162,1853,446
14000US24033801707,"Census Tract 8017.07, Prince George's, MD",2379,291,965,285,1414,300
14000US24033801709,"Census Tract 8017.09, Prince George's, MD",2121,217,1123,205,998,189
14000US24033801801,"Census Tract 8018.01, Prince George's, MD",858,86,294,89,564,92
14000US24033801802,"Census Tract 8018.02, Prince George's, MD",1810,224,895,249,915,213
14000US24033801807,"Census Tract 8018.07, Prince George's, MD",2070,382,969,329,1101,245
14000US24033801808,"Census Tract 8018.08, Prince George's, MD",1580,155,588,134,992,163
14000US24033801809,"Census Tract 8018.09, Prince George's, MD",1957,208,1145,197,812,183
14000US24033801901,"Census Tract 8019.01, Prince George's, MD",1657,190,1532,199,125,93
14000US24033801904,"Census Tract 8019.04, Prince George's, MD",1327,140,716,113,611,140
14000US24033801905,"Census Tract 8019.05, Prince George's, MD",3251,330,1366,301,1885,244
14000US24033801906,"Census Tract 8019.06, Prince George's, MD",786,120,400,101,386,66
14000US24033801907,"Census Tract 8019.07, Prince George's, MD",1839,263,769,136,1070,266
14000US24033801908,"Census Tract 8019.08, Prince George's, MD",1377,200,40,37,1337,194
14000US24033802001,"Census Tract 8020.01, Prince George's, MD",2165,160,557,174,1608,166
14000US24033802002,"Census Tract 8020.02, Prince George's, MD",1798,258,1419,276,379,122
14000US24033802103,"Census Tract 8021.03, Prince George's, MD",1063,113,908,134,155,73
14000US24033802104,"Census Tract 8021.04, Prince George's, MD",967,150,444,94,523,155
14000US24033802106,"Census Tract 8021.06, Prince George's, MD",1863,283,639,154,1224,238
14000US24033802107,"Census Tract 8021.07, Prince George's, MD",1621,226,329,111,1292,255
14000US24033802201,"Census Tract 8022.01, Prince George's, MD",2173,264,1972,286,201,106
14000US24033802203,"Census Tract 8022.03, Prince George's, MD",1719,318,1122,260,597,231
14000US24033802204,"Census Tract 8022.04, Prince George's, MD",1931,151,1741,208,190,132
14000US24033802301,"Census Tract 8023.01, Prince George's, MD",1119,196,1000,206,119,72
14000US24033802404,"Census Tract 8024.04, Prince George's, MD",1668,163,419,118,1249,156
14000US24033802405,"Census Tract 8024.05, Prince George's, MD",1606,217,495,110,1111,215
14000US24033802406,"Census Tract 8024.06, Prince George's, MD",945,142,396,129,549,103
14000US24033802407,"Census Tract 8024.07, Prince George's, MD",1992,333,288,91,1704,335
14000US24033802408,"Census Tract 8024.08, Prince George's, MD",1078,132,328,113,750,102
14000US24033802501,"Census Tract 8025.01, Prince George's, MD",1289,91,487,129,802,146
14000US24033802502,"Census Tract 8025.02, Prince George's, MD",944,125,850,128,94,49
14000US24033802600,"Census Tract 8026, Prince George's, MD",1290,167,1039,206,251,111
14000US24033802700,"Census Tract 8027, Prince George's, MD",925,247,572,149,353,152
14000US24033802803,"Census Tract 8028.03, Prince George's, MD",2371,307,1477,263,894,253
14000US24033802804,"Census Tract 8028.04, Prince George's, MD",1861,198,1307,246,554,179
14000US24033802805,"Census Tract 8028.05, Prince George's, MD",1862,235,1528,207,334,160
14000US24033802901,"Census Tract 8029.01, Prince George's, MD",1869,335,994,223,875,376
14000US24033803001,"Census Tract 8030.01, Prince George's, MD",1197,199,757,118,440,194
14000US24033803002,"Census Tract 8030.02, Prince George's, MD",1072,174,735,171,337,170
14000US24033803100,"Census Tract 8031, Prince George's, MD",1214,139,664,124,550,128
14000US24033803200,"Census Tract 8032, Prince George's, MD",1161,131,392,131,769,141
14000US24033803300,"Census Tract 8033, Prince George's, MD",1645,273,1129,135,516,295
14000US24033803403,"Census Tract 8034.03, Prince George's, MD",2273,263,1124,225,1149,283
14000US24033803508,"Census Tract 8035.08, Prince George's, MD",1211,147,576,108,635,154
14000US24033803509,"Census Tract 8035.09, Prince George's, MD",1411,190,393,120,1018,195
14000US24033803512,"Census Tract 8035.12, Prince George's, MD",2560,308,1722,215,838,266
14000US24033803513,"Census Tract 8035.13, Prince George's, MD",2389,447,1367,375,1022,351
14000US24033803514,"Census Tract 8035.14, Prince George's, MD",2779,219,1207,244,1572,279
14000US24033803516,"Census Tract 8035.16, Prince George's, MD",1609,119,1495,139,114,81
14000US24033803519,"Census Tract 8035.19, Prince George's, MD",2689,205,972,216,1717,288
14000US24033803520,"Census Tract 8035.20, Prince George's, MD",1588,378,1555,380,33,25
14000US24033803521,"Census Tract 8035.21, Prince George's, MD",2926,412,2592,441,334,143
14000US24033803524,"Census Tract 8035.24, Prince George's, MD",1739,234,1186,271,553,144
14000US24033803525,"Census Tract 8035.25, Prince George's, MD",984,116,158,75,826,125
14000US24033803526,"Census Tract 8035.26, Prince George's, MD",1392,152,1177,164,215,115
14000US24033803527,"Census Tract 8035.27, Prince George's, MD",1295,195,1103,141,192,156
14000US24033803528,"Census Tract 8035.28, Prince George's, MD",2619,156,2125,206,494,179
14000US24033803601,"Census Tract 8036.01, Prince George's, MD",1137,124,1089,119,48,53
14000US24033803602,"Census Tract 8036.02, Prince George's, MD",829,141,480,118,349,107
14000US24033803605,"Census Tract 8036.05, Prince George's, MD",2018,249,1604,226,414,189
14000US24033803606,"Census Tract 8036.06, Prince George's, MD",1427,129,1289,153,138,95
14000US24033803607,"Census Tract 8036.07, Prince George's, MD",1022,125,888,127,134,79
14000US24033803608,"Census Tract 8036.08, Prince George's, MD",1835,184,1321,171,514,164
14000US24033803610,"Census Tract 8036.10, Prince George's, MD",1093,196,677,121,416,191
14000US24033803612,"Census Tract 8036.12, Prince George's, MD",1524,150,339,102,1185,142
14000US24033803613,"Census Tract 8036.13, Prince George's, MD",2610,362,728,244,1882,264
14000US24033803700,"Census Tract 8037, Prince George's, MD",813,102,754,107,59,43
14000US24033803801,"Census Tract 8038.01, Prince George's, MD",687,89,633,94,54,33
14000US24033803803,"Census Tract 8038.03, Prince George's, MD",1724,208,1343,209,381,116
14000US24033803900,"Census Tract 8039, Prince George's, MD",1011,133,451,121,560,104
14000US24033804001,"Census Tract 8040.01, Prince George's, MD",2059,296,159,84,1900,300
14000US24033804002,"Census Tract 8040.02, Prince George's, MD",1205,183,518,138,687,173
14000US24033804101,"Census Tract 8041.01, Prince George's, MD",1072,179,584,165,488,124
14000US24033804102,"Census Tract 8041.02, Prince George's, MD",2273,387,1067,246,1206,367
14000US24033804200,"Census Tract 8042, Prince George's, MD",1205,249,1093,253,112,75
14000US24033804300,"Census Tract 8043, Prince George's, MD",1220,141,392,157,828,139
14000US24033804400,"Census Tract 8044, Prince George's, MD",921,109,694,122,227,60
14000US24033804600,"Census Tract 8046, Prince George's, MD",1270,210,786,138,484,140
14000US24033804700,"Census Tract 8047, Prince George's, MD",1483,317,894,190,589,295
14000US24033804801,"Census Tract 8048.01, Prince George's, MD",1382,223,6,18,1376,223
14000US24033804802,"Census Tract 8048.02, Prince George's, MD",1197,207,11,17,1186,210
14000US24033804900,"Census Tract 8049, Prince George's, MD",1485,154,437,131,1048,140
14000US24033805000,"Census Tract 8050, Prince George's, MD",2338,327,974,245,1364,302
14000US24033805101,"Census Tract 8051.01, Prince George's, MD",1241,256,396,123,845,239
14000US24033805201,"Census Tract 8052.01, Prince George's, MD",1375,224,478,136,897,238
14000US24033805202,"Census Tract 8052.02, Prince George's, MD",1149,140,327,110,822,146
14000US24033805500,"Census Tract 8055, Prince George's, MD",1156,177,504,72,652,194
14000US24033805601,"Census Tract 8056.01, Prince George's, MD",1709,304,76,61,1633,305
14000US24033805602,"Census Tract 8056.02, Prince George's, MD",1420,296,60,45,1360,301
14000US24033805700,"Census Tract 8057, Prince George's, MD",1773,153,706,153,1067,156
14000US24033805801,"Census Tract 8058.01, Prince George's, MD",988,146,817,138,171,84
14000US24033805802,"Census Tract 8058.02, Prince George's, MD",1228,166,896,158,332,116
14000US24033805904,"Census Tract 8059.04, Prince George's, MD",948,87,689,104,259,80
14000US24033805906,"Census Tract 8059.06, Prince George's, MD",1282,206,283,103,999,231
14000US24033805907,"Census Tract 8059.07, Prince George's, MD",1273,148,396,143,877,178
14000US24033805908,"Census Tract 8059.08, Prince George's, MD",1258,172,275,120,983,130
14000US24033805909,"Census Tract 8059.09, Prince George's, MD",1927,286,334,109,1593,260
14000US24033806000,"Census Tract 8060, Prince George's, MD",2281,308,973,248,1308,254
14000US24033806100,"Census Tract 8061, Prince George's, MD",1478,181,971,152,507,158
14000US24033806400,"Census Tract 8064, Prince George's, MD",1575,222,1117,180,458,146
14000US24033806501,"Census Tract 8065.01, Prince George's, MD",1609,184,587,138,1022,224
14000US24033806601,"Census Tract 8066.01, Prince George's, MD",1473,250,740,186,733,221
14000US24033806602,"Census Tract 8066.02, Prince George's, MD",1340,113,788,131,552,127
14000US24033806706,"Census Tract 8067.06, Prince George's, MD",1400,169,1074,158,326,107
14000US24033806708,"Census Tract 8067.08, Prince George's, MD",2277,316,1174,316,1103,173
14000US24033806710,"Census Tract 8067.10, Prince George's, MD",2130,316,1474,312,656,243
14000US24033806711,"Census Tract 8067.11, Prince George's, MD",1791,197,911,212,880,167
14000US24033806712,"Census Tract 8067.12, Prince George's, MD",1545,384,892,380,653,261
14000US24033806713,"Census Tract 8067.13, Prince George's, MD",1333,152,35,52,1298,151
14000US24033806714,"Census Tract 8067.14, Prince George's, MD",2074,239,405,114,1669,237
14000US24033806800,"Census Tract 8068, Prince George's, MD",1188,121,1052,119,136,64
14000US24033806900,"Census Tract 8069, Prince George's, MD",1505,178,1242,141,263,143
14000US24033807000,"Census Tract 8070, Prince George's, MD",3554,398,982,247,2572,425
14000US24033807102,"Census Tract 8071.02, Prince George's, MD",1112,150,805,124,307,94
14000US24033807301,"Census Tract 8073.01, Prince George's, MD",1404,174,326,77,1078,187
14000US24033807304,"Census Tract 8073.04, Prince George's, MD",644,98,540,88,104,77
14000US24033807305,"Census Tract 8073.05, Prince George's, MD",1148,198,693,153,455,189
14000US24033807404,"Census Tract 8074.04, Prince George's, MD",1681,191,1087,213,594,172
14000US24033807405,"Census Tract 8074.05, Prince George's, MD",2068,294,1147,189,921,236
14000US24033807407,"Census Tract 8074.07, Prince George's, MD",2251,255,1427,223,824,225
14000US24033807408,"Census Tract 8074.08, Prince George's, MD",2370,340,1928,349,442,153
14000US24033807409,"Census Tract 8074.09, Prince George's, MD",1097,129,349,78,748,115
14000US24033807410,"Census Tract 8074.10, Prince George's, MD",2381,262,994,224,1387,305
14000US24033807500,"Census Tract 8075, Prince George's, MD",2765,299,1570,310,1195,231
14000US24033980000,"Census Tract 9800, Prince George's, MD",1440,210,153,58,1287,210
14000US24035810100,"Census Tract 8101, Queen Anne's, MD",1105,128,1008,143,97,70
14000US24035810200,"Census Tract 8102, Queen Anne's, MD",1003,107,766,114,237,78
14000US24035810300,"Census Tract 8103, Queen Anne's, MD",2053,222,1803,222,250,87
14000US24035810400,"Census Tract 8104, Queen Anne's, MD",2215,239,1773,248,442,163
14000US24035810500,"Census Tract 8105, Queen Anne's, MD",1915,154,1492,168,423,118
14000US24035810600,"Census Tract 8106, Queen Anne's, MD",1897,150,1721,155,176,62
14000US24035810700,"Census Tract 8107, Queen Anne's, MD",1488,177,1167,167,321,131
14000US24035810800,"Census Tract 8108, Queen Anne's, MD",2540,301,1880,280,660,211
14000US24035810901,"Census Tract 8109.01, Queen Anne's, MD",2415,246,2007,188,408,169
14000US24035810902,"Census Tract 8109.02, Queen Anne's, MD",1130,92,1013,105,117,66
14000US24035811000,"Census Tract 8110, Queen Anne's, MD",1876,185,1342,168,534,135
14000US24035990000,"Census Tract 9900, Queen Anne's, MD",0,14,0,14,0,14
14000US24035990100,"Census Tract 9901, Queen Anne's, MD",0,14,0,14,0,14
14000US24035990200,"Census Tract 9902, Queen Anne's, MD",0,14,0,14,0,14
14000US24037875000,"Census Tract 8750, St. Mary's, MD",2055,243,1945,259,110,75
14000US24037875100,"Census Tract 8751, St. Mary's, MD",1734,220,1488,217,246,132
14000US24037875201,"Census Tract 8752.01, St. Mary's, MD",2053,167,1931,149,122,89
14000US24037875202,"Census Tract 8752.02, St. Mary's, MD",2038,297,1951,309,87,77
14000US24037875300,"Census Tract 8753, St. Mary's, MD",1335,152,1170,163,165,94
14000US24037875400,"Census Tract 8754, St. Mary's, MD",2643,317,2036,263,607,209
14000US24037875501,"Census Tract 8755.01, St. Mary's, MD",2619,261,2146,240,473,164
14000US24037875502,"Census Tract 8755.02, St. Mary's, MD",1520,228,1056,180,464,248
14000US24037875601,"Census Tract 8756.01, St. Mary's, MD",716,75,560,86,156,73
14000US24037875602,"Census Tract 8756.02, St. Mary's, MD",2815,299,1694,236,1121,266
14000US24037875700,"Census Tract 8757, St. Mary's, MD",2347,308,2098,274,249,162
14000US24037875803,"Census Tract 8758.03, St. Mary's, MD",2072,195,1358,181,714,170
14000US24037875903,"Census Tract 8759.03, St. Mary's, MD",1382,332,665,134,717,348
14000US24037875904,"Census Tract 8759.04, St. Mary's, MD",2318,343,1017,261,1301,325
14000US24037875905,"Census Tract 8759.05, St. Mary's, MD",970,174,703,135,267,132
14000US24037875906,"Census Tract 8759.06, St. Mary's, MD",2014,186,876,181,1138,255
14000US24037876001,"Census Tract 8760.01, St. Mary's, MD",2356,274,1031,225,1325,296
14000US24037876003,"Census Tract 8760.03, St. Mary's, MD",1131,227,1069,227,62,73
14000US24037876004,"Census Tract 8760.04, St. Mary's, MD",2626,244,1330,173,1296,250
14000US24037876101,"Census Tract 8761.01, St. Mary's, MD",1632,168,1411,166,221,105
14000US24037876102,"Census Tract 8761.02, St. Mary's, MD",1103,205,885,222,218,127
14000US24037876200,"Census Tract 8762, St. Mary's, MD",2264,295,1905,300,359,167
14000US24037990000,"Census Tract 9900, St. Mary's, MD",0,14,0,14,0,14
14000US24039930101,"Census Tract 9301.01, Somerset, MD",2104,270,639,171,1465,281
14000US24039930102,"Census Tract 9301.02, Somerset, MD",1691,197,1424,181,267,122
14000US24039930200,"Census Tract 9302, Somerset, MD",715,120,607,102,108,62
14000US24039930500,"Census Tract 9305, Somerset, MD",1606,182,1470,184,136,60
14000US24039930600,"Census Tract 9306, Somerset, MD",1178,173,639,102,539,147
14000US24039930800,"Census Tract 9308, Somerset, MD",1002,175,931,177,71,45
14000US24039990100,"Census Tract 9901, Somerset, MD",0,14,0,14,0,14
14000US24041960100,"Census Tract 9601, Talbot, MD",1400,129,1101,138,299,117
14000US24041960201,"Census Tract 9602.01, Talbot, MD",1870,251,1535,243,335,118
14000US24041960300,"Census Tract 9603, Talbot, MD",1689,183,738,166,951,201
14000US24041960400,"Census Tract 9604, Talbot, MD",2475,237,1125,220,1350,273
14000US24041960501,"Census Tract 9605.01, Talbot, MD",1843,154,1570,151,273,89
14000US24041960502,"Census Tract 9605.02, Talbot, MD",1690,229,1347,225,343,97
14000US24041960600,"Census Tract 9606, Talbot, MD",809,92,736,90,73,34
14000US24041960700,"Census Tract 9607, Talbot, MD",1801,210,1455,187,346,105
14000US24041960800,"Census Tract 9608, Talbot, MD",919,146,848,145,71,59
14000US24041960900,"Census Tract 9609, Talbot, MD",1715,166,1329,154,386,118
14000US24041990000,"Census Tract 9900, Talbot, MD",0,14,0,14,0,14
14000US24043000100,"Census Tract 1, Washington, MD",1787,223,1106,185,681,172
14000US24043000200,"Census Tract 2, Washington, MD",1731,188,1360,174,371,114
14000US24043000301,"Census Tract 3.01, Washington, MD",1437,171,868,139,569,181
14000US24043000302,"Census Tract 3.02, Washington, MD",878,150,363,127,515,143
14000US24043000400,"Census Tract 4, Washington, MD",977,139,139,65,838,144
14000US24043000500,"Census Tract 5, Washington, MD",2658,276,815,142,1843,296
14000US24043000601,"Census Tract 6.01, Washington, MD",1015,146,303,80,712,146
14000US24043000602,"Census Tract 6.02, Washington, MD",1647,210,1003,146,644,197
14000US24043000700,"Census Tract 7, Washington, MD",1448,188,406,144,1042,186
14000US24043000800,"Census Tract 8, Washington, MD",1749,224,598,137,1151,214
14000US24043000900,"Census Tract 9, Washington, MD",1349,255,492,186,857,234
14000US24043001001,"Census Tract 10.01, Washington, MD",1878,239,1050,184,828,229
14000US24043001002,"Census Tract 10.02, Washington, MD",1506,126,1186,137,320,80
14000US24043010100,"Census Tract 101, Washington, MD",431,72,384,77,47,34
14000US24043010200,"Census Tract 102, Washington, MD",1897,237,1731,243,166,70
14000US24043010300,"Census Tract 103, Washington, MD",2898,331,2456,324,442,191
14000US24043010401,"Census Tract 104.01, Washington, MD",1818,187,1226,201,592,212
14000US24043010402,"Census Tract 104.02, Washington, MD",2250,348,1864,390,386,182
14000US24043010600,"Census Tract 106, Washington, MD",1903,203,1652,208,251,88
14000US24043010700,"Census Tract 107, Washington, MD",1536,186,1112,146,424,117
14000US24043010802,"Census Tract 108.02, Washington, MD",1153,139,735,135,418,117
14000US24043010803,"Census Tract 108.03, Washington, MD",1717,205,943,127,774,187
14000US24043010901,"Census Tract 109.01, Washington, MD",2397,395,1973,281,424,282
14000US24043010902,"Census Tract 109.02, Washington, MD",1117,155,972,172,145,103
14000US24043011000,"Census Tract 110, Washington, MD",0,14,0,14,0,14
14000US24043011100,"Census Tract 111, Washington, MD",2910,324,1862,295,1048,266
14000US24043011202,"Census Tract 112.02, Washington, MD",1687,241,846,154,841,188
14000US24043011203,"Census Tract 112.03, Washington, MD",1876,204,853,198,1023,191
14000US24043011204,"Census Tract 112.04, Washington, MD",1596,227,1058,199,538,160
14000US24043011301,"Census Tract 113.01, Washington, MD",1945,229,1493,242,452,115
14000US24043011302,"Census Tract 113.02, Washington, MD",1416,171,1255,167,161,74
14000US24043011400,"Census Tract 114, Washington, MD",2616,236,1959,273,657,209
14000US24043011501,"Census Tract 115.01, Washington, MD",1610,217,1360,163,250,161
14000US24043011502,"Census Tract 115.02, Washington, MD",1310,197,1089,212,221,100
14000US24043011600,"Census Tract 116, Washington, MD",1152,148,961,132,191,80
14000US24043011700,"Census Tract 117, Washington, MD",2116,323,1672,322,444,158
14000US24045000100,"Census Tract 1, Wicomico, MD",2072,314,683,219,1389,325
14000US24045000200,"Census Tract 2, Wicomico, MD",761,113,288,73,473,96
14000US24045000300,"Census Tract 3, Wicomico, MD",499,162,15,17,484,164
14000US24045000400,"Census Tract 4, Wicomico, MD",1531,226,511,97,1020,212
14000US24045000500,"Census Tract 5, Wicomico, MD",873,189,332,126,541,170
14000US24045010101,"Census Tract 101.01, Wicomico, MD",2729,263,1293,219,1436,247
14000US24045010102,"Census Tract 101.02, Wicomico, MD",1362,161,875,159,487,118
14000US24045010200,"Census Tract 102, Wicomico, MD",2432,297,981,279,1451,339
14000US24045010300,"Census Tract 103, Wicomico, MD",3241,239,2444,245,797,253
14000US24045010400,"Census Tract 104, Wicomico, MD",2432,353,1630,312,802,247
14000US24045010501,"Census Tract 105.01, Wicomico, MD",1878,207,1501,213,377,161
14000US24045010503,"Census Tract 105.03, Wicomico, MD",1448,219,80,61,1368,219
14000US24045010504,"Census Tract 105.04, Wicomico, MD",2150,299,663,167,1487,308
14000US24045010603,"Census Tract 106.03, Wicomico, MD",3744,331,2024,248,1720,285
14000US24045010604,"Census Tract 106.04, Wicomico, MD",2228,259,1718,259,510,118
14000US24045010605,"Census Tract 106.05, Wicomico, MD",1474,172,1413,169,61,51
14000US24045010606,"Census Tract 106.06, Wicomico, MD",1620,165,1476,165,144,75
14000US24045010701,"Census Tract 107.01, Wicomico, MD",1637,169,1386,154,251,111
14000US24045010703,"Census Tract 107.03, Wicomico, MD",1820,262,1426,249,394,173
14000US24045010704,"Census Tract 107.04, Wicomico, MD",1702,225,1369,226,333,138
14000US24045010800,"Census Tract 108, Wicomico, MD",2401,356,2186,343,215,147
14000US24047950000,"Census Tract 9500, Worcester, MD",936,148,455,101,481,143
14000US24047950100,"Census Tract 9501, Worcester, MD",1199,193,956,180,243,123
14000US24047950300,"Census Tract 9503, Worcester, MD",1875,256,1569,240,306,124
14000US24047950400,"Census Tract 9504, Worcester, MD",1383,227,1005,130,378,210
14000US24047950600,"Census Tract 9506, Worcester, MD",1321,175,1172,189,149,75
14000US24047950700,"Census Tract 9507, Worcester, MD",1185,180,978,167,207,85
14000US24047950800,"Census Tract 9508, Worcester, MD",2322,275,1974,297,348,166
14000US24047950900,"Census Tract 9509, Worcester, MD",910,118,729,102,181,88
14000US24047951000,"Census Tract 9510, Worcester, MD",1858,190,1031,163,827,178
14000US24047951101,"Census Tract 9511.01, Worcester, MD",1586,231,1452,236,134,64
14000US24047951102,"Census Tract 9511.02, Worcester, MD",1692,209,1536,211,156,107
14000US24047951200,"Census Tract 9512, Worcester, MD",1362,205,1094,207,268,141
14000US24047951300,"Census Tract 9513, Worcester, MD",1052,141,672,129,380,90
14000US24047951400,"Census Tract 9514, Worcester, MD",1252,156,1003,130,249,136
14000US24047951500,"Census Tract 9515, Worcester, MD",2112,224,1263,215,849,278
14000US24047951700,"Census Tract 9517, Worcester, MD",1782,266,1397,241,385,135
14000US24047980000,"Census Tract 9800, Worcester, MD",0,14,0,14,0,14
14000US24047990000,"Census Tract 9900, Worcester, MD",0,14,0,14,0,14
14000US24510010100,"Census Tract 101, Baltimore, MD",1479,218,1216,210,263,83
14000US24510010200,"Census Tract 102, Baltimore, MD",1354,130,1024,117,330,117
14000US24510010300,"Census Tract 103, Baltimore, MD",965,167,680,171,285,98
14000US24510010400,"Census Tract 104, Baltimore, MD",1573,210,1039,229,534,125
14000US24510010500,"Census Tract 105, Baltimore, MD",868,98,454,87,414,107
14000US24510020100,"Census Tract 201, Baltimore, MD",885,104,467,95,418,80
14000US24510020200,"Census Tract 202, Baltimore, MD",783,105,328,87,455,100
14000US24510020300,"Census Tract 203, Baltimore, MD",2403,355,611,139,1792,332
14000US24510030100,"Census Tract 301, Baltimore, MD",825,213,136,71,689,191
14000US24510030200,"Census Tract 302, Baltimore, MD",1459,236,620,199,839,204
14000US24510040100,"Census Tract 401, Baltimore, MD",4852,450,227,138,4625,468
14000US24510040200,"Census Tract 402, Baltimore, MD",463,102,13,20,450,99
14000US24510060100,"Census Tract 601, Baltimore, MD",1147,290,847,170,300,267
14000US24510060200,"Census Tract 602, Baltimore, MD",1066,178,528,140,538,180
14000US24510060300,"Census Tract 603, Baltimore, MD",696,113,397,77,299,88
14000US24510060400,"Census Tract 604, Baltimore, MD",919,131,306,72,613,144
14000US24510070100,"Census Tract 701, Baltimore, MD",724,151,330,129,394,142
14000US24510070200,"Census Tract 702, Baltimore, MD",1029,159,486,151,543,140
14000US24510070300,"Census Tract 703, Baltimore, MD",346,87,171,49,175,77
14000US24510070400,"Census Tract 704, Baltimore, MD",730,146,73,51,657,150
14000US24510080101,"Census Tract 801.01, Baltimore, MD",1470,206,917,205,553,183
14000US24510080102,"Census Tract 801.02, Baltimore, MD",619,131,264,82,355,127
14000US24510080200,"Census Tract 802, Baltimore, MD",394,69,222,78,172,60
14000US24510080301,"Census Tract 803.01, Baltimore, MD",701,140,261,83,440,114
14000US24510080302,"Census Tract 803.02, Baltimore, MD",1006,144,554,178,452,159
14000US24510080400,"Census Tract 804, Baltimore, MD",408,93,117,62,291,108
14000US24510080500,"Census Tract 805, Baltimore, MD",540,132,249,100,291,96
14000US24510080600,"Census Tract 806, Baltimore, MD",609,89,220,76,389,93
14000US24510080700,"Census Tract 807, Baltimore, MD",330,63,145,45,185,64
14000US24510080800,"Census Tract 808, Baltimore, MD",778,191,270,91,508,207
14000US24510090100,"Census Tract 901, Baltimore, MD",1663,198,907,181,756,154
14000US24510090200,"Census Tract 902, Baltimore, MD",1368,185,1227,184,141,87
14000US24510090300,"Census Tract 903, Baltimore, MD",2095,391,1061,140,1034,388
14000US24510090400,"Census Tract 904, Baltimore, MD",639,127,200,64,439,114
14000US24510090500,"Census Tract 905, Baltimore, MD",575,73,296,72,279,85
14000US24510090600,"Census Tract 906, Baltimore, MD",858,147,339,82,519,159
14000US24510090700,"Census Tract 907, Baltimore, MD",922,201,452,165,470,187
14000US24510090800,"Census Tract 908, Baltimore, MD",828,176,383,133,445,195
14000US24510090900,"Census Tract 909, Baltimore, MD",946,159,219,97,727,158
14000US24510100100,"Census Tract 1001, Baltimore, MD",705,129,276,72,429,118
14000US24510100200,"Census Tract 1002, Baltimore, MD",1132,189,84,43,1048,194
14000US24510100300,"Census Tract 1003, Baltimore, MD",0,14,0,14,0,14
14000US24510110100,"Census Tract 1101, Baltimore, MD",1905,303,241,104,1664,306
14000US24510110200,"Census Tract 1102, Baltimore, MD",4268,535,654,163,3614,571
14000US24510120100,"Census Tract 1201, Baltimore, MD",2278,362,1089,173,1189,365
14000US24510120201,"Census Tract 1202.01, Baltimore, MD",872,117,476,71,396,117
14000US24510120202,"Census Tract 1202.02, Baltimore, MD",1539,257,300,129,1239,269
14000US24510120300,"Census Tract 1203, Baltimore, MD",1463,181,682,146,781,204
14000US24510120400,"Census Tract 1204, Baltimore, MD",769,87,257,68,512,84
14000US24510120500,"Census Tract 1205, Baltimore, MD",1312,200,502,123,810,161
14000US24510120600,"Census Tract 1206, Baltimore, MD",1597,189,204,67,1393,216
14000US24510120700,"Census Tract 1207, Baltimore, MD",1077,129,556,106,521,154
14000US24510130100,"Census Tract 1301, Baltimore, MD",1650,292,280,147,1370,299
14000US24510130200,"Census Tract 1302, Baltimore, MD",1153,213,516,135,637,193
14000US24510130300,"Census Tract 1303, Baltimore, MD",862,99,295,74,567,106
14000US24510130400,"Census Tract 1304, Baltimore, MD",823,115,338,90,485,109
14000US24510130600,"Census Tract 1306, Baltimore, MD",1874,233,1173,211,701,162
14000US24510130700,"Census Tract 1307, Baltimore, MD",2523,254,1332,213,1191,235
14000US24510130803,"Census Tract 1308.03, Baltimore, MD",1370,212,748,186,622,145
14000US24510130804,"Census Tract 1308.04, Baltimore, MD",867,83,503,74,364,65
14000US24510130805,"Census Tract 1308.05, Baltimore, MD",610,77,324,76,286,74
14000US24510130806,"Census Tract 1308.06, Baltimore, MD",703,104,499,98,204,70
14000US24510140100,"Census Tract 1401, Baltimore, MD",2161,287,666,126,1495,286
14000US24510140200,"Census Tract 1402, Baltimore, MD",1048,432,373,377,675,181
14000US24510140300,"Census Tract 1403, Baltimore, MD",996,163,318,100,678,155
14000US24510150100,"Census Tract 1501, Baltimore, MD",1121,192,640,197,481,144
14000US24510150200,"Census Tract 1502, Baltimore, MD",862,212,416,130,446,208
14000US24510150300,"Census Tract 1503, Baltimore, MD",507,110,301,80,206,100
14000US24510150400,"Census Tract 1504, Baltimore, MD",1469,233,471,166,998,222
14000US24510150500,"Census Tract 1505, Baltimore, MD",723,92,336,77,387,99
14000US24510150600,"Census Tract 1506, Baltimore, MD",1370,348,330,126,1040,345
14000US24510150701,"Census Tract 1507.01, Baltimore, MD",673,104,511,108,162,72
14000US24510150702,"Census Tract 1507.02, Baltimore, MD",740,88,565,105,175,93
14000US24510150800,"Census Tract 1508, Baltimore, MD",1916,353,839,198,1077,374
14000US24510150900,"Census Tract 1509, Baltimore, MD",1223,290,852,212,371,222
14000US24510151000,"Census Tract 1510, Baltimore, MD",1907,244,1060,237,847,252
14000US24510151100,"Census Tract 1511, Baltimore, MD",2792,302,2188,389,604,255
14000US24510151200,"Census Tract 1512, Baltimore, MD",1554,208,591,231,963,211
14000US24510151300,"Census Tract 1513, Baltimore, MD",1577,311,686,177,891,305
14000US24510160100,"Census Tract 1601, Baltimore, MD",1024,231,123,78,901,219
14000US24510160200,"Census Tract 1602, Baltimore, MD",903,181,426,155,477,157
14000US24510160300,"Census Tract 1603, Baltimore, MD",571,191,120,65,451,192
14000US24510160400,"Census Tract 1604, Baltimore, MD",756,160,255,81,501,148
14000US24510160500,"Census Tract 1605, Baltimore, MD",1426,300,732,268,694,204
14000US24510160600,"Census Tract 1606, Baltimore, MD",1288,219,437,170,851,229
14000US24510160700,"Census Tract 1607, Baltimore, MD",1428,206,650,183,778,203
14000US24510160801,"Census Tract 1608.01, Baltimore, MD",1196,107,744,162,452,142
14000US24510160802,"Census Tract 1608.02, Baltimore, MD",1005,145,653,146,352,123
14000US24510170100,"Census Tract 1701, Baltimore, MD",959,140,74,41,885,148
14000US24510170200,"Census Tract 1702, Baltimore, MD",1378,192,36,35,1342,193
14000US24510170300,"Census Tract 1703, Baltimore, MD",883,138,239,68,644,140
14000US24510180300,"Census Tract 1803, Baltimore, MD",889,179,195,87,694,171
14000US24510190100,"Census Tract 1901, Baltimore, MD",769,173,208,60,561,183
14000US24510190200,"Census Tract 1902, Baltimore, MD",747,169,367,126,380,150
14000US24510190300,"Census Tract 1903, Baltimore, MD",785,166,133,66,652,170
14000US24510200100,"Census Tract 2001, Baltimore, MD",581,195,171,72,410,207
14000US24510200200,"Census Tract 2002, Baltimore, MD",674,137,285,91,389,138
14000US24510200300,"Census Tract 2003, Baltimore, MD",381,76,157,76,224,78
14000US24510200400,"Census Tract 2004, Baltimore, MD",371,79,139,77,232,55
14000US24510200500,"Census Tract 2005, Baltimore, MD",875,221,237,187,638,204
14000US24510200600,"Census Tract 2006, Baltimore, MD",1066,208,540,120,526,194
14000US24510200701,"Census Tract 2007.01, Baltimore, MD",1914,258,1064,189,850,262
14000US24510200702,"Census Tract 2007.02, Baltimore, MD",516,135,333,126,183,73
14000US24510200800,"Census Tract 2008, Baltimore, MD",794,133,293,86,501,120
14000US24510210100,"Census Tract 2101, Baltimore, MD",1094,169,533,146,561,149
14000US24510210200,"Census Tract 2102, Baltimore, MD",1591,254,586,202,1005,287
14000US24510220100,"Census Tract 2201, Baltimore, MD",2702,358,1027,297,1675,279
14000US24510230100,"Census Tract 2301, Baltimore, MD",1227,294,360,125,867,280
14000US24510230200,"Census Tract 2302, Baltimore, MD",829,75,486,87,343,86
14000US24510230300,"Census Tract 2303, Baltimore, MD",803,116,227,71,576,100
14000US24510240100,"Census Tract 2401, Baltimore, MD",1876,196,1132,194,744,190
14000US24510240200,"Census Tract 2402, Baltimore, MD",1550,137,977,146,573,112
14000US24510240300,"Census Tract 2403, Baltimore, MD",1055,82,608,100,447,109
14000US24510240400,"Census Tract 2404, Baltimore, MD",1332,178,898,158,434,113
14000US24510250101,"Census Tract 2501.01, Baltimore, MD",1666,240,1103,164,563,274
14000US24510250102,"Census Tract 2501.02, Baltimore, MD",1269,236,491,148,778,242
14000US24510250103,"Census Tract 2501.03, Baltimore, MD",1709,217,645,126,1064,238
14000US24510250203,"Census Tract 2502.03, Baltimore, MD",761,92,157,54,604,90
14000US24510250204,"Census Tract 2502.04, Baltimore, MD",1574,261,75,39,1499,262
14000US24510250205,"Census Tract 2502.05, Baltimore, MD",1331,137,410,132,921,150
14000US24510250206,"Census Tract 2502.06, Baltimore, MD",907,118,550,107,357,92
14000US24510250207,"Census Tract 2502.07, Baltimore, MD",797,80,94,54,703,104
14000US24510250301,"Census Tract 2503.01, Baltimore, MD",708,141,302,85,406,139
14000US24510250303,"Census Tract 2503.03, Baltimore, MD",752,110,418,104,334,104
14000US24510250401,"Census Tract 2504.01, Baltimore, MD",1532,225,615,152,917,240
14000US24510250402,"Census Tract 2504.02, Baltimore, MD",1560,202,586,179,974,250
14000US24510250500,"Census Tract 2505, Baltimore, MD",2180,494,1255,476,925,216
14000US24510250600,"Census Tract 2506, Baltimore, MD",29,22,5,8,24,24
14000US24510260101,"Census Tract 2601.01, Baltimore, MD",1926,183,1101,148,825,194
14000US24510260102,"Census Tract 2601.02, Baltimore, MD",1939,193,1462,238,477,163
14000US24510260201,"Census Tract 2602.01, Baltimore, MD",2478,370,770,238,1708,403
14000US24510260202,"Census Tract 2602.02, Baltimore, MD",2834,406,835,235,1999,419
14000US24510260203,"Census Tract 2602.03, Baltimore, MD",1016,107,443,109,573,117
14000US24510260301,"Census Tract 2603.01, Baltimore, MD",1438,172,785,162,653,129
14000US24510260302,"Census Tract 2603.02, Baltimore, MD",2551,241,1959,265,592,202
14000US24510260303,"Census Tract 2603.03, Baltimore, MD",727,253,211,220,516,152
14000US24510260401,"Census Tract 2604.01, Baltimore, MD",1102,130,523,142,579,162
14000US24510260402,"Census Tract 2604.02, Baltimore, MD",1304,166,295,100,1009,177
14000US24510260403,"Census Tract 2604.03, Baltimore, MD",732,144,193,108,539,108
14000US24510260404,"Census Tract 2604.04, Baltimore, MD",444,94,128,55,316,105
14000US24510260501,"Census Tract 2605.01, Baltimore, MD",1701,178,840,186,861,222
14000US24510260604,"Census Tract 2606.04, Baltimore, MD",542,167,114,67,428,159
14000US24510260605,"Census Tract 2606.05, Baltimore, MD",2133,300,1306,324,827,205
14000US24510260700,"Census Tract 2607, Baltimore, MD",1083,129,659,139,424,131
14000US24510260800,"Census Tract 2608, Baltimore, MD",920,142,389,106,531,141
14000US24510260900,"Census Tract 2609, Baltimore, MD",2055,258,925,179,1130,269
14000US24510261000,"Census Tract 2610, Baltimore, MD",948,131,580,134,368,149
14000US24510261100,"Census Tract 2611, Baltimore, MD",997,130,680,142,317,71
14000US24510270101,"Census Tract 2701.01, Baltimore, MD",570,39,480,63,90,50
14000US24510270102,"Census Tract 2701.02, Baltimore, MD",1466,198,1123,212,343,131
14000US24510270200,"Census Tract 2702, Baltimore, MD",770,159,638,145,132,67
14000US24510270301,"Census Tract 2703.01, Baltimore, MD",1234,169,1049,192,185,112
14000US24510270302,"Census Tract 2703.02, Baltimore, MD",753,131,508,76,245,130
14000US24510270401,"Census Tract 2704.01, Baltimore, MD",1847,204,1289,219,558,204
14000US24510270402,"Census Tract 2704.02, Baltimore, MD",1136,202,1041,192,95,80
14000US24510270501,"Census Tract 2705.01, Baltimore, MD",1723,213,1509,194,214,149
14000US24510270502,"Census Tract 2705.02, Baltimore, MD",1607,151,1198,184,409,137
14000US24510270600,"Census Tract 2706, Baltimore, MD",1786,184,1519,163,267,154
14000US24510270701,"Census Tract 2707.01, Baltimore, MD",1062,119,0,14,1062,119
14000US24510270702,"Census Tract 2707.02, Baltimore, MD",1019,142,437,109,582,160
14000US24510270703,"Census Tract 2707.03, Baltimore, MD",1388,184,1036,234,352,130
14000US24510270801,"Census Tract 2708.01, Baltimore, MD",1375,122,965,190,410,160
14000US24510270802,"Census Tract 2708.02, Baltimore, MD",2466,452,1505,398,961,249
14000US24510270803,"Census Tract 2708.03, Baltimore, MD",2803,228,1255,228,1548,304
14000US24510270804,"Census Tract 2708.04, Baltimore, MD",1385,197,555,96,830,193
14000US24510270805,"Census Tract 2708.05, Baltimore, MD",2013,206,1429,234,584,131
14000US24510270901,"Census Tract 2709.01, Baltimore, MD",1673,201,814,222,859,244
14000US24510270902,"Census Tract 2709.02, Baltimore, MD",1318,130,1067,200,251,126
14000US24510270903,"Census Tract 2709.03, Baltimore, MD",1341,214,987,189,354,168
14000US24510271001,"Census Tract 2710.01, Baltimore, MD",938,103,315,84,623,125
14000US24510271002,"Census Tract 2710.02, Baltimore, MD",1449,148,834,184,615,148
14000US24510271101,"Census Tract 2711.01, Baltimore, MD",891,117,471,107,420,102
14000US24510271102,"Census Tract 2711.02, Baltimore, MD",512,77,486,84,26,28
14000US24510271200,"Census Tract 2712, Baltimore, MD",2147,218,1773,182,374,150
14000US24510271300,"Census Tract 2713, Baltimore, MD",1101,167,711,86,390,157
14000US24510271400,"Census Tract 2714, Baltimore, MD",1484,167,1129,148,355,89
14000US24510271501,"Census Tract 2715.01, Baltimore, MD",1777,164,1142,152,635,131
14000US24510271503,"Census Tract 2715.03, Baltimore, MD",621,86,512,87,109,47
14000US24510271600,"Census Tract 2716, Baltimore, MD",1312,214,595,159,717,184
14000US24510271700,"Census Tract 2717, Baltimore, MD",1758,230,820,142,938,254
14000US24510271801,"Census Tract 2718.01, Baltimore, MD",1112,183,469,149,643,161
14000US24510271802,"Census Tract 2718.02, Baltimore, MD",774,124,336,105,438,115
14000US24510271900,"Census Tract 2719, Baltimore, MD",1458,130,973,152,485,136
14000US24510272003,"Census Tract 2720.03, Baltimore, MD",2131,285,1069,187,1062,293
14000US24510272004,"Census Tract 2720.04, Baltimore, MD",1750,177,650,163,1100,143
14000US24510272005,"Census Tract 2720.05, Baltimore, MD",1294,145,696,162,598,101
14000US24510272006,"Census Tract 2720.06, Baltimore, MD",1575,118,484,110,1091,155
14000US24510272007,"Census Tract 2720.07, Baltimore, MD",1588,135,601,123,987,160
14000US24510280101,"Census Tract 2801.01, Baltimore, MD",1157,190,743,173,414,165
14000US24510280102,"Census Tract 2801.02, Baltimore, MD",2318,278,1331,268,987,315
14000US24510280200,"Census Tract 2802, Baltimore, MD",1625,209,1360,210,265,126
14000US24510280301,"Census Tract 2803.01, Baltimore, MD",2057,265,382,131,1675,260
14000US24510280302,"Census Tract 2803.02, Baltimore, MD",1249,403,408,160,841,374
14000US24510280401,"Census Tract 2804.01, Baltimore, MD",1519,206,1017,205,502,151
14000US24510280402,"Census Tract 2804.02, Baltimore, MD",602,85,530,99,72,55
14000US24510280403,"Census Tract 2804.03, Baltimore, MD",1848,170,984,180,864,173
14000US24510280404,"Census Tract 2804.04, Baltimore, MD",1121,135,498,137,623,168
14000US24510280500,"Census Tract 2805, Baltimore, MD",941,91,32,34,909,92
14000US24510280600,"Census Tract 2806, Baltimore, MD",1575,177,245,106,1330,185
